30 100
TAGGAGACGGTTTGGACCGCGGCGTACTCA|CGATCTCCTACATATGCCGTTAGCTTGCTG
GCATAAGAATTTCGACCCGGGTCAGTAAGA|TTGCTATTCGCGCATAAGCCCCACCGTCAT
TGTCTTAACGACGATTATGTATGCGCTGCT|AGCACTGCGCGTGTTCGCATGGGGTGGTCC
GTACTCATGATAGCGAGAGGGTGTGGTCCG|CTTGCTGCATGGAAACCGTGACGGTCGGCG
ACACCGCTGTTACTGAGCAATATAGTTATT|TGTTACTGAGCAAAAGGGTTGAACGATCTA
GCTTTAGCACCACAGAACGTGTTATGGACT|TACGTGGTCCGCAGACACCGCTGTTACTGA
CGGACCACTCGTCGTGGTCCGCAGACACCG|AGACACCGCTGTTACTGAGCAACTCCTTGG
ATGCCACAGAGTTCTGACGGAGCGGGTGGT|CCGCTGTTACTGAGCAAAATACGAACAAGG
AGACACCGCTGTTACTGAGCACGGTTGGCT|CAATACATTGTAACCAGTTGCCCTCCGTTC
CTGTCTTAACGACGATTATGTATGCGCTGC|GAGCACTGCGCGTGTTCGCATGGGGTGGTC
AAGAATTTCGACCCGGGTCAGTAAGACGCC|TATTCGCGCATAAGCCCCACCGTCATCTAC
GTTATTGACAGAAGCGAGGCTGCGATTCCA|GATCTACTCTGGCCATGAGAATGCGCATAA
TTCCTCGTACCAACACTTACAATATCTGTG|GAAAATAGTGGTCCGCAGACACCGCTGTTA
GGACCGCGGCGTACTCATGATAGCGAGAGG|ATGCCGTTAGCTTGCTGCATGGAAACCGTG
GGTGAATGCACGTTCGAGCTTAAAGCTATA|ATCGGGTTCCTCGTACCAACACTTACAATA
ACACCGCTGTTACTGAGCAATACATTGTAA|GCAATATAGTTATTGACAGAAGCGAGGCTG
CGGTGAATGCACGTTCGAGCTTAAAGCTAT|TATCGGGTTCCTCGTACCAACACTTACAAT
TCCGCAGACACCGCTGTTACTGAGCAGGTC|GGCGGATGGTGGTCCGCAGACACCGCTGTT
ACCCGGGTCAGTAAGACGCCTATCGGCTCT|TAAGCCCCACCGTCATCTACTCAGAGACAA
AGTGGTCCGCAGACACCGCTGTTACTGAGC|TAGAAAGATGTGCGGTATATTCTCCAGGTA
AATGCACGTTCGAGCTTAAAGCTATAGGAT|GGTTCCTCGTACCAACACTTACAATATCTG
CGCGGAGAGCCCATGAGGATGCCACAGAGT|AGGGGTGGTCCGCAGACACCGCTGTTACTG
GAACGGAATTCAGTCCTTTAGCAAATGCAC|AAGACGCCTATCGGCTCTGAGCCTGGGGTG
CTTTAGCAAATGCACAAACTGGAGTGGTCC|TCTGAGCCTGGGGTGCTGTACGCACATGGC
TCCGCAGACACCGCTGTTACTGAGCAATAT|ACACCGCTGTTACTGAGCAAAAGGGTTGAA
CAGACACCGCTGTTACTGAGCATAACACAA|GAGCCCATGAGGATGCCACAGAGTTCTGAC
TTGTAACCAGTTGCCCTCCGTTCGATCTCC|AGGCTGCGATTCCAGGTGTAAGGGCAGCCT
GTAAGGGCAGCCTTTGGGAACGGAATTCAG|TTTCGACCCGGGTCAGTAAGACGCCTATCG
TTGCTGCATGGAAACCGTGACGGTCGGCGG|GTCCTTTAGCAAATGCACAAACTGGAGTGG
AGGTACCACCAGGCTTGAAACTAGGAGGGG|ACGATTATGTATGCGCTGCTGACCCGCTCC
ACCGCTGTTACTGAGCACTGCGCGTGTTCG|GTTACTGAGCATTTTCATTGGTAGGATTTA
CCGTTAGCTTGCTGCATGGAAACCGTGACG|GGAATTCAGTCCTTTAGCAAATGCACAAAC
ACCACAGAACGTGTTATGGACTGTCTTAAC|CCGCAGACACCGCTGTTACTGAGCACTGCG
ACCGCTGTTACTGAGCAGGTCCGCAGACAC|TGGTCCGCAGACACCGCTGTTACTGAGCAA
GAGTCCCGATACTTTTCTCGAAAATAGTGG|TACTGAGCAGGTCCGCAGACACCGCTGTTA
AGAAGCGAGGCTGCGATTCCAGGTGTAAGG|TGGCCATGAGAATGCGCATAAGAATTTCGA
GAGCAATATAGTTATTGACAGAAGCGAGGC|AGGGTTGAACGATCTACTCTGGCCATGAGA
CGTTAGCTTGCTGCATGGAAACCGTGACGG|GAATTCAGTCCTTTAGCAAATGCACAAACT
GCGGATGGTGGTCCGCAGACACCGCTGTTA|GTGGTCCGCAGACACCGCTGTTACTGAGCA
GTGGTCCGCAGACACCGCTGTTACTGAGCA|CGCAGACACCGCTGTTACTGAGCATTTTCA
TTAGCTTGCTGCATGGAAACCGTGACGGTC|ATTCAGTCCTTTAGCAAATGCACAAACTGG
TTCACGGATGCGGTGAATGCACGTTCGAGC|CAAGCTGAGGTATCGGGTTCCTCGTACCAA
AACACAAGCCGAGTACGCTTTTATCACAGG|TTCTGACGGAGCGGGTGGTCCGCAGACACC
ACACCGCTGTTACTGAGCAAAATACGAACA|CTTCACGGATGCGGTGAATGCACGTTCGAG
GTACCACCAGGCTTGAAACTAGGAGGGGTG|GATTATGTATGCGCTGCTGACCCGCTCCTA
CGCTGTTACTGAGCATTTTCATTGGTAGGA|TAGGAGACGGTTTGGACCGCGGCGTACTCA
TCGACCCGGGTCAGTAAGACGCCTATCGGC|GCATAAGCCCCACCGTCATCTACTCAGAGA
AAGATGTGCGGTATATTCTCCAGGTACCAC|GTGTTATGGACTGTCTTAACGACGATTATG
CGGAATTCAGTCCTTTAGCAAATGCACAAA|ACGCCTATCGGCTCTGAGCCTGGGGTGCTG
AGACACCGCTGTTACTGAGCACTGCGCGTG|CGCTGTTACTGAGCATTTTCATTGGTAGGA
GCAGACACCGCTGTTACTGAGCAACTCCTT|GCTGTTACTGAGCACTGAGCATAGGCAATC
GAACAAGGCATAGTCAACAACTGTGAGCTT|TCGAGCTTAAAGCTATAGGATGATAATACG
ATACGAACAAGGCATAGTCAACAACTGTGA|ACGTTCGAGCTTAAAGCTATAGGATGATAA
GCTGTTACTGAGCAAAATACGAACAAGGCA|CGGATGCGGTGAATGCACGTTCGAGCTTAA
CGATACTTTTCTCGAAAATAGTGGTCCGCA|GCAGGTCCGCAGACACCGCTGTTACTGAGC
AACTGTGAGCTTTAGCACCACAGAACGTGT|GATGATAATACGTGGTCCGCAGACACCGCT
TGAGCAATACATTGTAACCAGTTGCCCTCC|TGACAGAAGCGAGGCTGCGATTCCAGGTGT
AAATAGTGGTCCGCAGACACCGCTGTTACT|CCGCTGTTACTGAGCAATACATTGTAACCA
TTTCATTGGTAGGATTTAAAGCCGTAGTGA|CCGCGGCGTACTCATGATAGCGAGAGGGTG
TGTTACTGAGCATAACACAAGCCGAGTACG|GGATGCCACAGAGTTCTGACGGAGCGGGTG
GCAAAATACGAACAAGGCATAGTCAACAAC|AATGCACGTTCGAGCTTAAAGCTATAGGAT
CATTTTCATTGGTAGGATTTAAAGCCGTAG|GGACCGCGGCGTACTCATGATAGCGAGAGG
ACCGCTGTTACTGAGCAAGCTGAGGTATCG|TGTACTGCATGGAGAGTCCCGATACTTTTC
CACCGCTGTTACTGAGCAATATAGTTATTG|GTTACTGAGCAAAAGGGTTGAACGATCTAC
AGTGGTCCGCAGACACCGCTGTTACTGAGC|TGTTACTGAGCAATACATTGTAACCAGTTG
TGAGCAATATAGTTATTGACAGAAGCGAGG|AAGGGTTGAACGATCTACTCTGGCCATGAG
TGCATGGAAACCGTGACGGTCGGCGGATGG|TTTAGCAAATGCACAAACTGGAGTGGTCCG
GTTCGCATGGGGTGGTCCGCAGACACCGCT|ATTTAAAGCCGTAGTGAGCCGTATTGTACT
GAGCAAGCTGAGGTATCGGGTTCCTCGTAC|AGAGTCCCGATACTTTTCTCGAAAATAGTG
CTGTTACTGAGCATTTTCATTGGTAGGATT|GGAGACGGTTTGGACCGCGGCGTACTCATG
GGTCCGCAGACACCGCTGTTACTGAGCACC|AGGCATAGTCAACAACTGTGAGCTTTAGCA
ATTGTAACCAGTTGCCCTCCGTTCGATCTC|GAGGCTGCGATTCCAGGTGTAAGGGCAGCC
CAATATCTGTGGTGGTCCGCAGACACCGCT|CACCGCTGTTACTGAGCACGGTTGGCTAGG
TCTCCAGGTACCACCAGGCTTGAAACTAGG|TAACGACGATTATGTATGCGCTGCTGACCC
GCCACAGAGTTCTGACGGAGCGGGTGGTCC|GCTGTTACTGAGCAAAATACGAACAAGGCA
AGTGGTCCGCAGACACCGCTGTTACTGAGC|CACATGGCTCCGGATAACTCGGGCGGAAGA
TAGTGGTCCGCAGACACCGCTGTTACTGAG|CTGTTACTGAGCAATACATTGTAACCAGTT
TGAGCAGGTCCGCAGACACCGCTGTTACTG|CACCGCTGTTACTGAGCAATATAGTTATTG
CTGAGCAAAAGGGTTGAACGATCTACTCTG|GGAAGAGCGATCTATTCCACTTGGGGCAAA
GTGTAAGGGCAGCCTTTGGGAACGGAATTC|AATTTCGACCCGGGTCAGTAAGACGCCTAT
GGTATATTCTCCAGGTACCACCAGGCTTGA|ACTGTCTTAACGACGATTATGTATGCGCTG
ACGGATGCGGTGAATGCACGTTCGAGCTTA|GCTGAGGTATCGGGTTCCTCGTACCAACAC
CTGCTGACCCGCTCCTATTGAATAACTTCA|GGTCCGCAGACACCGCTGTTACTGAGCAAG
TCTAGAAAGATGTGCGGTATATTCTCCAGG|CAGAACGTGTTATGGACTGTCTTAACGACG
TTGTATACGGTGCAGGCGCCGTGGTCCGCA|CACCGCTGTTAGTGGTCCGCAGACACCGCT
GCAGACACCGCTGTTACTGAGCAAAATACG|ATAACTTCACGGATGCGGTGAATGCACGTT
ACACCGCTGTTACTGAGCACCACTTCTAGA|CAACAACTGTGAGCTTTAGCACCACAGAAC
CAAGCCGAGTACGCTTTTATCACAGGTGGT|GACGGAGCGGGTGGTCCGCAGACACCGCTG
TGGTCCGCAGACACCGCTGTTACTGAGCAA|CATGGCTCCGGATAACTCGGGCGGAAGAGC
TAATACGTGGTCCGCAGACACCGCTGTTAC|GTGGTCCGCAGACACCGCTGTTACTGAGCA
TACTGAGCAACTCCTTGGTGGTCCGCAGAC|CTGAGCATAGGCAATCTTTCGCGGAGAGCC
GTGAGCTTTAGCACCACAGAACGTGTTATG|ATAATACGTGGTCCGCAGACACCGCTGTTA
ATAATACGTGGTCCGCAGACACCGCTGTTA|GGTGGTCCGCAGACACCGCTGTTACTGAGC
GCAAGGCTGATTAAATATGTGTCTTTTTCG|GAGCATAACACAAGCCGAGTACGCTTTTAT
AAAGATGTGCGGTATATTCTCCAGGTACCA|CGTGTTATGGACTGTCTTAACGACGATTAT
CCGCAGACACCGCTGTTACTGAGCACTGCG|ACACCGCTGTTACTGAGCATTTTCATTGGT
GTCTTAACGACGATTATGTATGCGCTGCTG|GCACTGCGCGTGTTCGCATGGGGTGGTCCG
CAGACACCGCTGTTACTGAGCAATACATTG|TGAGCAATATAGTTATTGACAGAAGCGAGG
AGAGTCCCGATACTTTTCTCGAAAATAGTG|TTACTGAGCAGGTCCGCAGACACCGCTGTT
CGACGATTATGTATGCGCTGCTGACCCGCT|GCGTGTTCGCATGGGGTGGTCCGCAGACAC
CACCGCTGTTACTGAGCAAAAGGGTTGAAC|ATAACTCGGGCGGAAGAGCGATCTATTCCA
CCGCTGTTACTGAGCAATACATTGTAACCA|ATATAGTTATTGACAGAAGCGAGGCTGCGA
TTCAGTCCTTTAGCAAATGCACAAACTGGA|TATCGGCTCTGAGCCTGGGGTGCTGTACGC
AAGGGCAGCCTTTGGGAACGGAATTCAGTC|TCGACCCGGGTCAGTAAGACGCCTATCGGC
GTGAGCCGTATTGTACTGCATGGAGAGTCC|GGTGTGGTCCGCAGACACCGCTGTTACTGA
TACTGAGCAATATAGTTATTGACAGAAGCG|CAAAAGGGTTGAACGATCTACTCTGGCCAT
CTTGAAACTAGGAGGGGTGGTCCGCAGACA|CGCTGCTGACCCGCTCCTATTGAATAACTT
TTTTCTCGAAAATAGTGGTCCGCAGACACC|CCGCAGACACCGCTGTTACTGAGCAATACA
CTACTCTGGCCATGAGAATGCGCATAAGAA|GGGGCAAAACCGTTGACGTCATTGCTATTC
CCCATGAGGATGCCACAGAGTTCTGACGGA|CCGCAGACACCGCTGTTACTGAGCAAAATA
CTAGGAGACGGTTTGGACCGCGGCGTACTC|TCGATCTCCTACATATGCCGTTAGCTTGCT
CCCGATACTTTTCTCGAAAATAGTGGTCCG|GAGCAGGTCCGCAGACACCGCTGTTACTGA
AAGCTGAGGTATCGGGTTCCTCGTACCAAC|TCCCGATACTTTTCTCGAAAATAGTGGTCC
TCGAGCTTAAAGCTATAGGATGATAATACG|TACCAACACTTACAATATCTGTGGTGGTCC
CCGCTGTTACTGAGCAACTCCTTGGTGGTC|CTGAGCACTGAGCATAGGCAATCTTTCGCG
GAGCAAAATACGAACAAGGCATAGTCAACA|TGAATGCACGTTCGAGCTTAAAGCTATAGG
AAAGGGTTGAACGATCTACTCTGGCCATGA|CGATCTATTCCACTTGGGGCAAAACCGTTG
CCGTGACGGTCGGCGGATGGTGGTCCGCAG|GCACAAACTGGAGTGGTCCGCAGACACCGC
AAGCCGAGTACGCTTTTATCACAGGTGGTC|ACGGAGCGGGTGGTCCGCAGACACCGCTGT
ACACCGCTGTTACTGAGCAGCTTGTCTATG|CCTTGGTGGTCCGCAGACACCGCTGTTACT
GTGGTCCGCAGACACCGCTGTTACTGAGCA|AGAAAGATGTGCGGTATATTCTCCAGGTAC
ACTGCATGGAGAGTCCCGATACTTTTCTCG|ACACCGCTGTTACTGAGCAGGTCCGCAGAC
GCCGTATTGTACTGCATGGAGAGTCCCGAT|TGGTCCGCAGACACCGCTGTTACTGAGCAG
CCCGGGTCAGTAAGACGCCTATCGGCTCTG|AAGCCCCACCGTCATCTACTCAGAGACAAG
CAATACATTGTAACCAGTTGCCCTCCGTTC|AGAAGCGAGGCTGCGATTCCAGGTGTAAGG
TGTGAGCTTTAGCACCACAGAACGTGTTAT|GATAATACGTGGTCCGCAGACACCGCTGTT
TGTATGCGCTGCTGACCCGCTCCTATTGAA|CATGGGGTGGTCCGCAGACACCGCTGTTAC
TTTTTCGCAGCTAACATCATGGATTTGTAT|CTTTTATCACAGGTGGTCCGCAGACACCGC
CGAACAAGGCATAGTCAACAACTGTGAGCT|TTCGAGCTTAAAGCTATAGGATGATAATAC
CTGTTACTGAGCAAAAGGGTTGAACGATCT|TCGGGCGGAAGAGCGATCTATTCCACTTGG
AGGCGCCGTGGTCCGCAGACACCGCTGTTA|GGTCCGCAGACACCGCTGTTACTGAGCACT
GACACCGCTGTTACTGAGCACCACTTCTAG|TCAACAACTGTGAGCTTTAGCACCACAGAA
CTTTCGCGGAGAGCCCATGAGGATGCCACA|TAGGAGGGGTGGTCCGCAGACACCGCTGTT
CTTGGTGGTCCGCAGACACCGCTGTTACTG|ATCTTTCGCGGAGAGCCCATGAGGATGCCA
CAAGCTGAGGTATCGGGTTCCTCGTACCAA|GTCCCGATACTTTTCTCGAAAATAGTGGTC
GCACAAACTGGAGTGGTCCGCAGACACCGC|GGTGCTGTACGCACATGGCTCCGGATAACT
GTCCGCAGACACCGCTGTTACTGAGCACTG|AAGATGTGCGGTATATTCTCCAGGTACCAC
GCATTTTCATTGGTAGGATTTAAAGCCGTA|TGGACCGCGGCGTACTCATGATAGCGAGAG
ACTGCGCGTGTTCGCATGGGGTGGTCCGCA|ATTGGTAGGATTTAAAGCCGTAGTGAGCCG
CAAAAGGGTTGAACGATCTACTCTGGCCAT|AGCGATCTATTCCACTTGGGGCAAAACCGT
TACGAACAAGGCATAGTCAACAACTGTGAG|CGTTCGAGCTTAAAGCTATAGGATGATAAT
CAGGTCCGCAGACACCGCTGTTACTGAGCA|GCTGTTACTGAGCAATATAGTTATTGACAG
GAGTTCTGACGGAGCGGGTGGTCCGCAGAC|ACTGAGCAAAATACGAACAAGGCATAGTCA
CATAGGCAATCTTTCGCGGAGAGCCCATGA|GGCTTGAAACTAGGAGGGGTGGTCCGCAGA
TACTGAGCAAAATACGAACAAGGCATAGTC|GCGGTGAATGCACGTTCGAGCTTAAAGCTA
ACGGTGCAGGCGCCGTGGTCCGCAGACACC|TGTTAGTGGTCCGCAGACACCGCTGTTACT
GTGTTCGCATGGGGTGGTCCGCAGACACCG|GGATTTAAAGCCGTAGTGAGCCGTATTGTA
ACTGAGCAGCTTGTCTATGGCAAGGCTGAT|CGCAGACACCGCTGTTACTGAGCATAACAC
TTAGTGGTCCGCAGACACCGCTGTTACTGA|TCTAGAAAGATGTGCGGTATATTCTCCAGG
TTACTGAGCACGGTTGGCTAGGAGACGGTT|AACCAGTTGCCCTCCGTTCGATCTCCTACA
ACGAACAAGGCATAGTCAACAACTGTGAGC|GTTCGAGCTTAAAGCTATAGGATGATAATA
GGAACGGAATTCAGTCCTTTAGCAAATGCA|TAAGACGCCTATCGGCTCTGAGCCTGGGGT
CGCAGACACCGCTGTTACTGAGCACTGAGC|ATGTGCGGTATATTCTCCAGGTACCACCAG
CGCAGACACCGCTGTTACTGAGCAGCTTGT|CAACTCCTTGGTGGTCCGCAGACACCGCTG
CAAACTGGAGTGGTCCGCAGACACCGCTGT|GCTGTACGCACATGGCTCCGGATAACTCGG
CCACAGAGTTCTGACGGAGCGGGTGGTCCG|CTGTTACTGAGCAAAATACGAACAAGGCAT
TATTCTCCAGGTACCACCAGGCTTGAAACT|TCTTAACGACGATTATGTATGCGCTGCTGA
GATTTAAAGCCGTAGTGAGCCGTATTGTAC|CATGATAGCGAGAGGGTGTGGTCCGCAGAC
CATATGCCGTTAGCTTGCTGCATGGAAACC|GGGAACGGAATTCAGTCCTTTAGCAAATGC
GATCTCCTACATATGCCGTTAGCTTGCTGC|GCAGCCTTTGGGAACGGAATTCAGTCCTTT
ATGCGGTGAATGCACGTTCGAGCTTAAAGC|AGGTATCGGGTTCCTCGTACCAACACTTAC
GCTGTTACTGAGCATAACACAAGCCGAGTA|GAGGATGCCACAGAGTTCTGACGGAGCGGG
AGCCCATGAGGATGCCACAGAGTTCTGACG|GTCCGCAGACACCGCTGTTACTGAGCAAAA
TGGCCATGAGAATGCGCATAAGAATTTCGA|AAACCGTTGACGTCATTGCTATTCGCGCAT
TGGTCCGCAGACACCGCTGTTACTGAGCAT|TCGCGGAGAGCCCATGAGGATGCCACAGAG
CCGCTGTTACTGAGCACTGCGCGTGTTCGC|TTACTGAGCATTTTCATTGGTAGGATTTAA
GGAGCGGGTGGTCCGCAGACACCGCTGTTA|ATACGAACAAGGCATAGTCAACAACTGTGA
CTTACAATATCTGTGGTGGTCCGCAGACAC|CAGACACCGCTGTTACTGAGCACGGTTGGC
GATTCCAGGTGTAAGGGCAGCCTTTGGGAA|CGCATAAGAATTTCGACCCGGGTCAGTAAG
GAAGCGAGGCTGCGATTCCAGGTGTAAGGG|GGCCATGAGAATGCGCATAAGAATTTCGAC
GCTATAGGATGATAATACGTGGTCCGCAGA|ACAATATCTGTGGTGGTCCGCAGACACCGC
AACTTCACGGATGCGGTGAATGCACGTTCG|GAGCAAGCTGAGGTATCGGGTTCCTCGTAC
ATGGAAACCGTGACGGTCGGCGGATGGTGG|AGCAAATGCACAAACTGGAGTGGTCCGCAG
GTTGAACGATCTACTCTGGCCATGAGAATG|TATTCCACTTGGGGCAAAACCGTTGACGTC
TCATGATAGCGAGAGGGTGTGGTCCGCAGA|CTGCATGGAAACCGTGACGGTCGGCGGATG
ACTGGAGTGGTCCGCAGACACCGCTGTTAC|GTACGCACATGGCTCCGGATAACTCGGGCG
GCATGGGGTGGTCCGCAGACACCGCTGTTA|AAAGCCGTAGTGAGCCGTATTGTACTGCAT
GAGTGGTCCGCAGACACCGCTGTTACTGAG|GCACATGGCTCCGGATAACTCGGGCGGAAG
GCAGACACCGCTGTTACTGAGCAATATAGT|CCGCTGTTACTGAGCAAAAGGGTTGAACGA
AGCGAGAGGGTGTGGTCCGCAGACACCGCT|GAAACCGTGACGGTCGGCGGATGGTGGTCC
TCCGCAGACACCGCTGTTACTGAGCACTGC|GACACCGCTGTTACTGAGCATTTTCATTGG
CAGACACCGCTGTTACTGAGCAGCTTGTCT|ACTCCTTGGTGGTCCGCAGACACCGCTGTT
AAGGCTGATTAAATATGTGTCTTTTTCGCA|GCATAACACAAGCCGAGTACGCTTTTATCA
TGTAAGGGCAGCCTTTGGGAACGGAATTCA|ATTTCGACCCGGGTCAGTAAGACGCCTATC
ACACCGCTGTTACTGAGCACGGTTGGCTAG|ATACATTGTAACCAGTTGCCCTCCGTTCGA
TGTTACTGAGCAACTCCTTGGTGGTCCGCA|GCACTGAGCATAGGCAATCTTTCGCGGAGA
CGGAGCGGGTGGTCCGCAGACACCGCTGTT|AATACGAACAAGGCATAGTCAACAACTGTG
TTACTGAGCAGCTTGTCTATGGCAAGGCTG|TCCGCAGACACCGCTGTTACTGAGCATAAC
CCGCTGTTACTGAGCACCACTTCTAGAAAG|CAACTGTGAGCTTTAGCACCACAGAACGTG
GCGCATAAGAATTTCGACCCGGGTCAGTAA|CATTGCTATTCGCGCATAAGCCCCACCGTC
TGGTGGTCCGCAGACACCGCTGTTACTGAG|TACTGAGCACGGTTGGCTAGGAGACGGTTT
GCGCCGTGGTCCGCAGACACCGCTGTTACT|TCCGCAGACACCGCTGTTACTGAGCACTGA
ATATCTGTGGTGGTCCGCAGACACCGCTGT|CCGCTGTTACTGAGCACGGTTGGCTAGGAG
GGCAATCTTTCGCGGAGAGCCCATGAGGAT|TGAAACTAGGAGGGGTGGTCCGCAGACACC
ACTGAGCACCACTTCTAGAAAGATGTGCGG|AGCTTTAGCACCACAGAACGTGTTATGGAC
TACTGAGCAGGTCCGCAGACACCGCTGTTA|AGACACCGCTGTTACTGAGCAATATAGTTA
AAGGCATAGTCAACAACTGTGAGCTTTAGC|GCTTAAAGCTATAGGATGATAATACGTGGT
CGCTGTTACTGAGCACGGTTGGCTAGGAGA|ATTGTAACCAGTTGCCCTCCGTTCGATCTC
AGCCTTTGGGAACGGAATTCAGTCCTTTAG|CGGGTCAGTAAGACGCCTATCGGCTCTGAG
CAGACACCGCTGTTACTGAGCAGGTCCGCA|GATGGTGGTCCGCAGACACCGCTGTTACTG
GCAGCTAACATCATGGATTTGTATACGGTG|TCACAGGTGGTCCGCAGACACCGCTGTTAG
CTTAAAGCTATAGGATGATAATACGTGGTC|ACACTTACAATATCTGTGGTGGTCCGCAGA
CTGGAGTGGTCCGCAGACACCGCTGTTACT|TACGCACATGGCTCCGGATAACTCGGGCGG
TGTTACTGAGCAAAATACGAACAAGGCATA|GATGCGGTGAATGCACGTTCGAGCTTAAAG
GGTCCGCAGACACCGCTGTTACTGAGCAAA|ATGGCTCCGGATAACTCGGGCGGAAGAGCG
GCAGACACCGCTGTTACTGAGCATTTTCAT|CGGTTGGCTAGGAGACGGTTTGGACCGCGG
ATTCTCCAGGTACCACCAGGCTTGAAACTA|CTTAACGACGATTATGTATGCGCTGCTGAC
GAGCTTTAGCACCACAGAACGTGTTATGGA|AATACGTGGTCCGCAGACACCGCTGTTACT
GTTACTGAGCAATATAGTTATTGACAGAAG|AGCAAAAGGGTTGAACGATCTACTCTGGCC
CAGACACCGCTGTTACTGAGCACGGTTGGC|GCAATACATTGTAACCAGTTGCCCTCCGTT
CAGGTGTAAGGGCAGCCTTTGGGAACGGAA|AAGAATTTCGACCCGGGTCAGTAAGACGCC
TTACTGAGCAATACATTGTAACCAGTTGCC|TTATTGACAGAAGCGAGGCTGCGATTCCAG
GATGTGCGGTATATTCTCCAGGTACCACCA|GTTATGGACTGTCTTAACGACGATTATGTA
GTGGTGGTCCGCAGACACCGCTGTTACTGA|TTACTGAGCACGGTTGGCTAGGAGACGGTT
CTTTAGCACCACAGAACGTGTTATGGACTG|ACGTGGTCCGCAGACACCGCTGTTACTGAG
CCAGGCTTGAAACTAGGAGGGGTGGTCCGC|GTATGCGCTGCTGACCCGCTCCTATTGAAT
TACTGAGCAAGCTGAGGTATCGGGTTCCTC|ATGGAGAGTCCCGATACTTTTCTCGAAAAT
CGGGTCAGTAAGACGCCTATCGGCTCTGAG|GCCCCACCGTCATCTACTCAGAGACAAGAG
CACCGCTGTTACTGAGCACCACTTCTAGAA|AACAACTGTGAGCTTTAGCACCACAGAACG
TGGGAACGGAATTCAGTCCTTTAGCAAATG|AGTAAGACGCCTATCGGCTCTGAGCCTGGG
TACTGAGCAATACATTGTAACCAGTTGCCC|TATTGACAGAAGCGAGGCTGCGATTCCAGG
TTAAAGCCGTAGTGAGCCGTATTGTACTGC|GATAGCGAGAGGGTGTGGTCCGCAGACACC
GTCTTTTTCGCAGCTAACATCATGGATTTG|ACGCTTTTATCACAGGTGGTCCGCAGACAC
GAGCAATACATTGTAACCAGTTGCCCTCCG|GACAGAAGCGAGGCTGCGATTCCAGGTGTA
TTGGGAACGGAATTCAGTCCTTTAGCAAAT|CAGTAAGACGCCTATCGGCTCTGAGCCTGG
TGTTCGCATGGGGTGGTCCGCAGACACCGC|GATTTAAAGCCGTAGTGAGCCGTATTGTAC
CTGAGCAAGCTGAGGTATCGGGTTCCTCGT|GGAGAGTCCCGATACTTTTCTCGAAAATAG
AGCTTTAGCACCACAGAACGTGTTATGGAC|ATACGTGGTCCGCAGACACCGCTGTTACTG
TGGTCCGCAGACACCGCTGTTACTGAGCAG|CTGAGCAACTCCTTGGTGGTCCGCAGACAC
CGGCGGATGGTGGTCCGCAGACACCGCTGT|GAGTGGTCCGCAGACACCGCTGTTACTGAG
CCGCTGTTACTGAGCAATATAGTTATTGAC|TACTGAGCAAAAGGGTTGAACGATCTACTC
GCTGTTACTGAGCATTTTCATTGGTAGGAT|AGGAGACGGTTTGGACCGCGGCGTACTCAT
TGCACGTTCGAGCTTAAAGCTATAGGATGA|TTCCTCGTACCAACACTTACAATATCTGTG
CCGCAGACACCGCTGTTACTGAGCAAGCTG|AGCCGTATTGTACTGCATGGAGAGTCCCGA
CAGACACCGCTGTTACTGAGCATTTTCATT|GGTTGGCTAGGAGACGGTTTGGACCGCGGC
AGTCAACAACTGTGAGCTTTAGCACCACAG|GCTATAGGATGATAATACGTGGTCCGCAGA
TACTGAGCACGGTTGGCTAGGAGACGGTTT|ACCAGTTGCCCTCCGTTCGATCTCCTACAT
CTGTTACTGAGCAAGCTGAGGTATCGGGTT|CTGCATGGAGAGTCCCGATACTTTTCTCGA
CAAATGCACAAACTGGAGTGGTCCGCAGAC|CCTGGGGTGCTGTACGCACATGGCTCCGGA
TGGTCCGCAGACACCGCTGTTACTGAGCAA|GACACCGCTGTTACTGAGCACTGAGCATAG
ACTGAGCACTGAGCATAGGCAATCTTTCGC|CCAGGTACCACCAGGCTTGAAACTAGGAGG
TACTGAGCACCACTTCTAGAAAGATGTGCG|GAGCTTTAGCACCACAGAACGTGTTATGGA
ACGCTTTTATCACAGGTGGTCCGCAGACAC|GTGGTCCGCAGACACCGCTGTTACTGAGCA
CAGAAGCGAGGCTGCGATTCCAGGTGTAAG|CTGGCCATGAGAATGCGCATAAGAATTTCG
TACATATGCCGTTAGCTTGCTGCATGGAAA|TTGGGAACGGAATTCAGTCCTTTAGCAAAT
AGGATTTAAAGCCGTAGTGAGCCGTATTGT|CTCATGATAGCGAGAGGGTGTGGTCCGCAG
ATTGTACTGCATGGAGAGTCCCGATACTTT|CGCAGACACCGCTGTTACTGAGCAGGTCCG
GCTTGTCTATGGCAAGGCTGATTAAATATG|CCGCTGTTACTGAGCATAACACAAGCCGAG
AGAAAGATGTGCGGTATATTCTCCAGGTAC|AACGTGTTATGGACTGTCTTAACGACGATT
AGACGGTTTGGACCGCGGCGTACTCATGAT|CTCCTACATATGCCGTTAGCTTGCTGCATG
TACAATATCTGTGGTGGTCCGCAGACACCG|GACACCGCTGTTACTGAGCACGGTTGGCTA
CTGTTACTGAGCACTGAGCATAGGCAATCT|ATTCTCCAGGTACCACCAGGCTTGAAACTA
TAGCGAGAGGGTGTGGTCCGCAGACACCGC|GGAAACCGTGACGGTCGGCGGATGGTGGTC
AGCGGGTGGTCCGCAGACACCGCTGTTACT|ACGAACAAGGCATAGTCAACAACTGTGAGC
TCGCAGCTAACATCATGGATTTGTATACGG|TATCACAGGTGGTCCGCAGACACCGCTGTT
CGTCGTGGTCCGCAGACACCGCTGTTACTG|TGTTACTGAGCAACTCCTTGGTGGTCCGCA
AGACACCGCTGTTACTGAGCAGGTCCGCAG|ATGGTGGTCCGCAGACACCGCTGTTACTGA
TCATTGGTAGGATTTAAAGCCGTAGTGAGC|GCGGCGTACTCATGATAGCGAGAGGGTGTG
TCTTTCGCGGAGAGCCCATGAGGATGCCAC|CTAGGAGGGGTGGTCCGCAGACACCGCTGT
TCCGTTCGATCTCCTACATATGCCGTTAGC|TGTAAGGGCAGCCTTTGGGAACGGAATTCA
GTATTGTACTGCATGGAGAGTCCCGATACT|TCCGCAGACACCGCTGTTACTGAGCAGGTC
CACGGATGCGGTGAATGCACGTTCGAGCTT|AGCTGAGGTATCGGGTTCCTCGTACCAACA
ACTCGTCGTGGTCCGCAGACACCGCTGTTA|CGCTGTTACTGAGCAACTCCTTGGTGGTCC
TGTGGTCCGCAGACACCGCTGTTACTGAGC|CGGTCGGCGGATGGTGGTCCGCAGACACCG
AGGCATAGTCAACAACTGTGAGCTTTAGCA|CTTAAAGCTATAGGATGATAATACGTGGTC
AAGCTATAGGATGATAATACGTGGTCCGCA|TTACAATATCTGTGGTGGTCCGCAGACACC
GTCCGCAGACACCGCTGTTACTGAGCACGG|ACTGAGCAATACATTGTAACCAGTTGCCCT
CTGCATGGAAACCGTGACGGTCGGCGGATG|CTTTAGCAAATGCACAAACTGGAGTGGTCC
GCACTGAGCATAGGCAATCTTTCGCGGAGA|TACCACCAGGCTTGAAACTAGGAGGGGTGG
GTGGTCCGCAGACACCGCTGTTACTGAGCA|ACATGGCTCCGGATAACTCGGGCGGAAGAG
ATAGGCAATCTTTCGCGGAGAGCCCATGAG|GCTTGAAACTAGGAGGGGTGGTCCGCAGAC
TCACAGGTGGTCCGCAGACACCGCTGTTAG|AGACACCGCTGTTACTGAGCACCACTTCTA
CGCAGACACCGCTGTTACTGAGCAGGTCCG|CGGATGGTGGTCCGCAGACACCGCTGTTAC
GGCCATGAGAATGCGCATAAGAATTTCGAC|AACCGTTGACGTCATTGCTATTCGCGCATA
AGACACCGCTGTTACTGAGCATTTTCATTG|GTTGGCTAGGAGACGGTTTGGACCGCGGCG
GGTCCGCAGACACCGCTGTTACTGAGCACG|TACTGAGCAATACATTGTAACCAGTTGCCC
TTGCCCTCCGTTCGATCTCCTACATATGCC|TCCAGGTGTAAGGGCAGCCTTTGGGAACGG
TGGCAAGGCTGATTAAATATGTGTCTTTTT|CTGAGCATAACACAAGCCGAGTACGCTTTT
CATGGATTTGTATACGGTGCAGGCGCCGTG|CCGCAGACACCGCTGTTAGTGGTCCGCAGA
GATAGCGAGAGGGTGTGGTCCGCAGACACC|ATGGAAACCGTGACGGTCGGCGGATGGTGG
AACAACTGTGAGCTTTAGCACCACAGAACG|TAGGATGATAATACGTGGTCCGCAGACACC
TGGACCGCGGCGTACTCATGATAGCGAGAG|TATGCCGTTAGCTTGCTGCATGGAAACCGT
TGTTACTGAGCACCACTTCTAGAAAGATGT|TGTGAGCTTTAGCACCACAGAACGTGTTAT
CAACACTTACAATATCTGTGGTGGTCCGCA|GTCCGCAGACACCGCTGTTACTGAGCACGG
CGCAGACACCGCTGTTACTGAGCAACTCCT|CGCTGTTACTGAGCACTGAGCATAGGCAAT
GACTGTCTTAACGACGATTATGTATGCGCT|CTGAGCACTGCGCGTGTTCGCATGGGGTGG
ATGTGCGGTATATTCTCCAGGTACCACCAG|TTATGGACTGTCTTAACGACGATTATGTAT
CAGACACCGCTGTTACTGAGCAAGCTGAGG|CGTATTGTACTGCATGGAGAGTCCCGATAC
ACCCGCTCCTATTGAATAACTTCACGGATG|CAGACACCGCTGTTACTGAGCAAGCTGAGG
GTTACTGAGCACCACTTCTAGAAAGATGTG|GTGAGCTTTAGCACCACAGAACGTGTTATG
CAGCTTGTCTATGGCAAGGCTGATTAAATA|CACCGCTGTTACTGAGCATAACACAAGCCG
TAACTTCACGGATGCGGTGAATGCACGTTC|TGAGCAAGCTGAGGTATCGGGTTCCTCGTA
GGTGCAGGCGCCGTGGTCCGCAGACACCGC|TTAGTGGTCCGCAGACACCGCTGTTACTGA
GTCCGCAGACACCGCTGTTACTGAGCACTG|AGACACCGCTGTTACTGAGCATTTTCATTG
GTCCTTTAGCAAATGCACAAACTGGAGTGG|GGCTCTGAGCCTGGGGTGCTGTACGCACAT
CGTGGTCCGCAGACACCGCTGTTACTGAGC|TACTGAGCAACTCCTTGGTGGTCCGCAGAC
CTGTTACTGAGCAACTCCTTGGTGGTCCGC|AGCACTGAGCATAGGCAATCTTTCGCGGAG
TGCTGACCCGCTCCTATTGAATAACTTCAC|GTCCGCAGACACCGCTGTTACTGAGCAAGC
AATGCACAAACTGGAGTGGTCCGCAGACAC|TGGGGTGCTGTACGCACATGGCTCCGGATA
CAGACACCGCTGTTACTGAGCACCACTTCT|AGTCAACAACTGTGAGCTTTAGCACCACAG
ATGTGTCTTTTTCGCAGCTAACATCATGGA|GAGTACGCTTTTATCACAGGTGGTCCGCAG
GGTGGTCCGCAGACACCGCTGTTACTGAGC|CCTATTGAATAACTTCACGGATGCGGTGAA
CGAGTACGCTTTTATCACAGGTGGTCCGCA|AGCGGGTGGTCCGCAGACACCGCTGTTACT
ACAAGCCGAGTACGCTTTTATCACAGGTGG|TGACGGAGCGGGTGGTCCGCAGACACCGCT
CTCGTACCAACACTTACAATATCTGTGGTG|AATAGTGGTCCGCAGACACCGCTGTTACTG
GACACCGCTGTTACTGAGCAAGCTGAGGTA|TATTGTACTGCATGGAGAGTCCCGATACTT
ATTTGTATACGGTGCAGGCGCCGTGGTCCG|GACACCGCTGTTAGTGGTCCGCAGACACCG
TCGGCGGATGGTGGTCCGCAGACACCGCTG|GGAGTGGTCCGCAGACACCGCTGTTACTGA
TACTGAGCATAACACAAGCCGAGTACGCTT|TGCCACAGAGTTCTGACGGAGCGGGTGGTC
CTCCTACATATGCCGTTAGCTTGCTGCATG|GCCTTTGGGAACGGAATTCAGTCCTTTAGC
AGACACCGCTGTTACTGAGCAATACATTGT|GAGCAATATAGTTATTGACAGAAGCGAGGC
CTCCAGGTACCACCAGGCTTGAAACTAGGA|AACGACGATTATGTATGCGCTGCTGACCCG
TCGATCTCCTACATATGCCGTTAGCTTGCT|GGGCAGCCTTTGGGAACGGAATTCAGTCCT
ACCGCTGTTACTGAGCATTTTCATTGGTAG|GCTAGGAGACGGTTTGGACCGCGGCGTACT
GACACCGCTGTTACTGAGCACTGAGCATAG|GCGGTATATTCTCCAGGTACCACCAGGCTT
CACGTTCGAGCTTAAAGCTATAGGATGATA|CCTCGTACCAACACTTACAATATCTGTGGT
CAAGGCTGATTAAATATGTGTCTTTTTCGC|AGCATAACACAAGCCGAGTACGCTTTTATC
GTGGTCCGCAGACACCGCTGTTACTGAGCA|CTATTGAATAACTTCACGGATGCGGTGAAT
CATAACACAAGCCGAGTACGCTTTTATCAC|GAGTTCTGACGGAGCGGGTGGTCCGCAGAC
CGCTGTTACTGAGCACTGAGCATAGGCAAT|ATATTCTCCAGGTACCACCAGGCTTGAAAC
TCCTTTAGCAAATGCACAAACTGGAGTGGT|GCTCTGAGCCTGGGGTGCTGTACGCACATG
GTAGGATTTAAAGCCGTAGTGAGCCGTATT|TACTCATGATAGCGAGAGGGTGTGGTCCGC
CGATCTCCTACATATGCCGTTAGCTTGCTG|GGCAGCCTTTGGGAACGGAATTCAGTCCTT
TACCACCAGGCTTGAAACTAGGAGGGGTGG|ATTATGTATGCGCTGCTGACCCGCTCCTAT
TTTCGCGGAGAGCCCATGAGGATGCCACAG|AGGAGGGGTGGTCCGCAGACACCGCTGTTA
TCTTTTTCGCAGCTAACATCATGGATTTGT|CGCTTTTATCACAGGTGGTCCGCAGACACC
GAGCAGCTTGTCTATGGCAAGGCTGATTAA|AGACACCGCTGTTACTGAGCATAACACAAG
TGGATTTGTATACGGTGCAGGCGCCGTGGT|GCAGACACCGCTGTTAGTGGTCCGCAGACA
GACCGCGGCGTACTCATGATAGCGAGAGGG|TGCCGTTAGCTTGCTGCATGGAAACCGTGA
CCGCAGACACCGCTGTTACTGAGCAATATA|CACCGCTGTTACTGAGCAAAAGGGTTGAAC
ACGTTCGAGCTTAAAGCTATAGGATGATAA|CTCGTACCAACACTTACAATATCTGTGGTG
GCAGACACCGCTGTTACTGAGCAAAAGGGT|TCCGGATAACTCGGGCGGAAGAGCGATCTA
GCTGTTACTGAGCAGGTCCGCAGACACCGC|TCCGCAGACACCGCTGTTACTGAGCAATAT
CCGCTGTTACTGAGCAGCTTGTCTATGGCA|TGGTGGTCCGCAGACACCGCTGTTACTGAG
GCAGACACCGCTGTTACTGAGCAGCTTGTC|AACTCCTTGGTGGTCCGCAGACACCGCTGT
AATACGAACAAGGCATAGTCAACAACTGTG|CACGTTCGAGCTTAAAGCTATAGGATGATA
CAACAACTGTGAGCTTTAGCACCACAGAAC|ATAGGATGATAATACGTGGTCCGCAGACAC
GCACCACTTCTAGAAAGATGTGCGGTATAT|TAGCACCACAGAACGTGTTATGGACTGTCT
GTGCAGGCGCCGTGGTCCGCAGACACCGCT|TAGTGGTCCGCAGACACCGCTGTTACTGAG
GTGGTCCGCAGACACCGCTGTTAGTGGTCC|CGCTGTTACTGAGCACCACTTCTAGAAAGA
GCCCATGAGGATGCCACAGAGTTCTGACGG|TCCGCAGACACCGCTGTTACTGAGCAAAAT
GGTCCGCAGACACCGCTGTTACTGAGCAAA|ATTGAATAACTTCACGGATGCGGTGAATGC
CGGTTTGGACCGCGGCGTACTCATGATAGC|CTACATATGCCGTTAGCTTGCTGCATGGAA
TGTGCGGTATATTCTCCAGGTACCACCAGG|TATGGACTGTCTTAACGACGATTATGTATG
GTGGTCCGCAGACACCGCTGTTACTGAGCA|ACTGAGCAACTCCTTGGTGGTCCGCAGACA
GGATGGTGGTCCGCAGACACCGCTGTTACT|GGTCCGCAGACACCGCTGTTACTGAGCAAA
AACATCATGGATTTGTATACGGTGCAGGCG|GTGGTCCGCAGACACCGCTGTTAGTGGTCC
GCAGGCGCCGTGGTCCGCAGACACCGCTGT|GTGGTCCGCAGACACCGCTGTTACTGAGCA
AACCAGTTGCCCTCCGTTCGATCTCCTACA|TGCGATTCCAGGTGTAAGGGCAGCCTTTGG
CTGACGGAGCGGGTGGTCCGCAGACACCGC|GCAAAATACGAACAAGGCATAGTCAACAAC
GTGGTCCGCAGACACCGCTGTTACTGAGCA|TAGTGAGCCGTATTGTACTGCATGGAGAGT
CATGGGGTGGTCCGCAGACACCGCTGTTAC|AAGCCGTAGTGAGCCGTATTGTACTGCATG
GCTGTTACTGAGCACGGTTGGCTAGGAGAC|TTGTAACCAGTTGCCCTCCGTTCGATCTCC
ATGCACGTTCGAGCTTAAAGCTATAGGATG|GTTCCTCGTACCAACACTTACAATATCTGT
TTACTGAGCAAAAGGGTTGAACGATCTACT|GGCGGAAGAGCGATCTATTCCACTTGGGGC
GTTCCTCGTACCAACACTTACAATATCTGT|CGAAAATAGTGGTCCGCAGACACCGCTGTT
ACCAGTTGCCCTCCGTTCGATCTCCTACAT|GCGATTCCAGGTGTAAGGGCAGCCTTTGGG
TGACGGTCGGCGGATGGTGGTCCGCAGACA|CAAACTGGAGTGGTCCGCAGACACCGCTGT
CTAACATCATGGATTTGTATACGGTGCAGG|AGGTGGTCCGCAGACACCGCTGTTAGTGGT
ATTATGTATGCGCTGCTGACCCGCTCCTAT|TTCGCATGGGGTGGTCCGCAGACACCGCTG
TCCTCGTACCAACACTTACAATATCTGTGG|AAAATAGTGGTCCGCAGACACCGCTGTTAC
CTGTTAGTGGTCCGCAGACACCGCTGTTAC|ACTTCTAGAAAGATGTGCGGTATATTCTCC
TCTGACGGAGCGGGTGGTCCGCAGACACCG|AGCAAAATACGAACAAGGCATAGTCAACAA
ACGGAATTCAGTCCTTTAGCAAATGCACAA|GACGCCTATCGGCTCTGAGCCTGGGGTGCT
GATTATGTATGCGCTGCTGACCCGCTCCTA|GTTCGCATGGGGTGGTCCGCAGACACCGCT
CACTGAGCATAGGCAATCTTTCGCGGAGAG|ACCACCAGGCTTGAAACTAGGAGGGGTGGT
CAAGGCATAGTCAACAACTGTGAGCTTTAG|AGCTTAAAGCTATAGGATGATAATACGTGG
GTTACTGAGCATAACACAAGCCGAGTACGC|GATGCCACAGAGTTCTGACGGAGCGGGTGG
GAGAATGCGCATAAGAATTTCGACCCGGGT|TGACGTCATTGCTATTCGCGCATAAGCCCC
CACCGCTGTTACTGAGCAAGCTGAGGTATC|TTGTACTGCATGGAGAGTCCCGATACTTTT
CTGAGCACGGTTGGCTAGGAGACGGTTTGG|CAGTTGCCCTCCGTTCGATCTCCTACATAT
TTGACAGAAGCGAGGCTGCGATTCCAGGTG|TACTCTGGCCATGAGAATGCGCATAAGAAT
AGGGTGTGGTCCGCAGACACCGCTGTTACT|GTGACGGTCGGCGGATGGTGGTCCGCAGAC
GGCAGCCTTTGGGAACGGAATTCAGTCCTT|ACCCGGGTCAGTAAGACGCCTATCGGCTCT
ACCGCTGTTACTGAGCACCACTTCTAGAAA|ACAACTGTGAGCTTTAGCACCACAGAACGT
GCTGTTACTGAGCAATACATTGTAACCAGT|ATAGTTATTGACAGAAGCGAGGCTGCGATT
TTAAAGCTATAGGATGATAATACGTGGTCC|CACTTACAATATCTGTGGTGGTCCGCAGAC
GCTGTTACTGAGCACTGAGCATAGGCAATC|TATTCTCCAGGTACCACCAGGCTTGAAACT
GGTGGTCCGCAGACACCGCTGTTACTGAGC|GTAGTGAGCCGTATTGTACTGCATGGAGAG
AGCACTGCGCGTGTTCGCATGGGGTGGTCC|TTCATTGGTAGGATTTAAAGCCGTAGTGAG
ACCGCTGTTACTGAGCAAAATACGAACAAG|TCACGGATGCGGTGAATGCACGTTCGAGCT
GCGGCGTACTCATGATAGCGAGAGGGTGTG|GTTAGCTTGCTGCATGGAAACCGTGACGGT
CTGTTACTGAGCAATATAGTTATTGACAGA|TGAGCAAAAGGGTTGAACGATCTACTCTGG
CACCGCTGTTACTGAGCACTGAGCATAGGC|GGTATATTCTCCAGGTACCACCAGGCTTGA
TTGTCTATGGCAAGGCTGATTAAATATGTG|GCTGTTACTGAGCATAACACAAGCCGAGTA
CGTGGTCCGCAGACACCGCTGTTACTGAGC|CAGACACCGCTGTTACTGAGCACTGAGCAT
TGTTACTGAGCATTTTCATTGGTAGGATTT|GAGACGGTTTGGACCGCGGCGTACTCATGA
GTCAACAACTGTGAGCTTTAGCACCACAGA|CTATAGGATGATAATACGTGGTCCGCAGAC
AGGTGTAAGGGCAGCCTTTGGGAACGGAAT|AGAATTTCGACCCGGGTCAGTAAGACGCCT
GGCTGCGATTCCAGGTGTAAGGGCAGCCTT|AGAATGCGCATAAGAATTTCGACCCGGGTC
ACACCGCTGTTAGTGGTCCGCAGACACCGC|AGCACCACTTCTAGAAAGATGTGCGGTATA
CTCCTATTGAATAACTTCACGGATGCGGTG|ACCGCTGTTACTGAGCAAGCTGAGGTATCG
CTGAGCAGGTCCGCAGACACCGCTGTTACT|ACACCGCTGTTACTGAGCAATATAGTTATT
CACCGCTGTTACTGAGCAGGTCCGCAGACA|GTGGTCCGCAGACACCGCTGTTACTGAGCA
CTGATTAAATATGTGTCTTTTTCGCAGCTA|AACACAAGCCGAGTACGCTTTTATCACAGG
AGTTATTGACAGAAGCGAGGCTGCGATTCC|CGATCTACTCTGGCCATGAGAATGCGCATA
GCTTTTATCACAGGTGGTCCGCAGACACCG|GGTCCGCAGACACCGCTGTTACTGAGCACC
CCGCTGTTAGTGGTCCGCAGACACCGCTGT|ACCACTTCTAGAAAGATGTGCGGTATATTC
CGAGCTTAAAGCTATAGGATGATAATACGT|ACCAACACTTACAATATCTGTGGTGGTCCG
CTGTTACTGAGCAAAATACGAACAAGGCAT|GGATGCGGTGAATGCACGTTCGAGCTTAAA
TACTGAGCAAAAGGGTTGAACGATCTACTC|GCGGAAGAGCGATCTATTCCACTTGGGGCA
TTTCTCGAAAATAGTGGTCCGCAGACACCG|CGCAGACACCGCTGTTACTGAGCAATACAT
GAGCACGGTTGGCTAGGAGACGGTTTGGAC|GTTGCCCTCCGTTCGATCTCCTACATATGC
CCGCAGACACCGCTGTTACTGAGCATTTTC|CACGGTTGGCTAGGAGACGGTTTGGACCGC
TATAGGATGATAATACGTGGTCCGCAGACA|AATATCTGTGGTGGTCCGCAGACACCGCTG
CGCTGTTACTGAGCAAGCTGAGGTATCGGG|TACTGCATGGAGAGTCCCGATACTTTTCTC
TTCTCCAGGTACCACCAGGCTTGAAACTAG|TTAACGACGATTATGTATGCGCTGCTGACC
CCGCTGTTACTGAGCACGGTTGGCTAGGAG|CATTGTAACCAGTTGCCCTCCGTTCGATCT
AAGCGAGGCTGCGATTCCAGGTGTAAGGGC|GCCATGAGAATGCGCATAAGAATTTCGACC
TGTACTGCATGGAGAGTCCCGATACTTTTC|CAGACACCGCTGTTACTGAGCAGGTCCGCA
TGTCTATGGCAAGGCTGATTAAATATGTGT|CTGTTACTGAGCATAACACAAGCCGAGTAC
ACTTACAATATCTGTGGTGGTCCGCAGACA|GCAGACACCGCTGTTACTGAGCACGGTTGG
AGCATAGGCAATCTTTCGCGGAGAGCCCAT|CAGGCTTGAAACTAGGAGGGGTGGTCCGCA
GCATGGAGAGTCCCGATACTTTTCTCGAAA|CCGCTGTTACTGAGCAGGTCCGCAGACACC
CACTTCTAGAAAGATGTGCGGTATATTCTC|ACCACAGAACGTGTTATGGACTGTCTTAAC
CACTTACAATATCTGTGGTGGTCCGCAGAC|CGCAGACACCGCTGTTACTGAGCACGGTTG
CCGCAGACACCGCTGTTACTGAGCACTGAG|GATGTGCGGTATATTCTCCAGGTACCACCA
GTCTATGGCAAGGCTGATTAAATATGTGTC|TGTTACTGAGCATAACACAAGCCGAGTACG
CGCTGTTACTGAGCAGGTCCGCAGACACCG|GTCCGCAGACACCGCTGTTACTGAGCAATA
TGTTACTGAGCACGGTTGGCTAGGAGACGG|GTAACCAGTTGCCCTCCGTTCGATCTCCTA
TGCGCTGCTGACCCGCTCCTATTGAATAAC|GGGTGGTCCGCAGACACCGCTGTTACTGAG
ATAGTTATTGACAGAAGCGAGGCTGCGATT|AACGATCTACTCTGGCCATGAGAATGCGCA
TTGAATAACTTCACGGATGCGGTGAATGCA|GTTACTGAGCAAGCTGAGGTATCGGGTTCC
TACTGAGCATTTTCATTGGTAGGATTTAAA|ACGGTTTGGACCGCGGCGTACTCATGATAG
AATACGTGGTCCGCAGACACCGCTGTTACT|TGGTCCGCAGACACCGCTGTTACTGAGCAT
GTTACTGAGCAACTCCTTGGTGGTCCGCAG|CACTGAGCATAGGCAATCTTTCGCGGAGAG
TGGTCCGCAGACACCGCTGTTACTGAGCAT|TGAGCACGGTTGGCTAGGAGACGGTTTGGA
TGTTACTGAGCAGGTCCGCAGACACCGCTG|CGCAGACACCGCTGTTACTGAGCAATATAG
TTCGAGCTTAAAGCTATAGGATGATAATAC|GTACCAACACTTACAATATCTGTGGTGGTC
AACTCCTTGGTGGTCCGCAGACACCGCTGT|AGGCAATCTTTCGCGGAGAGCCCATGAGGA
GTCCGCAGACACCGCTGTTACTGAGCAGGT|CGGCGGATGGTGGTCCGCAGACACCGCTGT
GTTATGGACTGTCTTAACGACGATTATGTA|CTGTTACTGAGCACTGCGCGTGTTCGCATG
TTCGCGGAGAGCCCATGAGGATGCCACAGA|GGAGGGGTGGTCCGCAGACACCGCTGTTAC
CCGCTGTTACTGAGCAAAAGGGTTGAACGA|AACTCGGGCGGAAGAGCGATCTATTCCACT
GGTTGGCTAGGAGACGGTTTGGACCGCGGC|CTCCGTTCGATCTCCTACATATGCCGTTAG
AAATGCACAAACTGGAGTGGTCCGCAGACA|CTGGGGTGCTGTACGCACATGGCTCCGGAT
CACAGGTGGTCCGCAGACACCGCTGTTAGT|GACACCGCTGTTACTGAGCACCACTTCTAG
GAATTTCGACCCGGGTCAGTAAGACGCCTA|TTCGCGCATAAGCCCCACCGTCATCTACTC
CAGAACGTGTTATGGACTGTCTTAACGACG|AGACACCGCTGTTACTGAGCACTGCGCGTG
CCGCAGACACCGCTGTTACTGAGCACCACT|CATAGTCAACAACTGTGAGCTTTAGCACCA
GATGCCACAGAGTTCTGACGGAGCGGGTGG|ACCGCTGTTACTGAGCAAAATACGAACAAG
TGTGTCTTTTTCGCAGCTAACATCATGGAT|AGTACGCTTTTATCACAGGTGGTCCGCAGA
GTACTGCATGGAGAGTCCCGATACTTTTCT|AGACACCGCTGTTACTGAGCAGGTCCGCAG
TCGCATGGGGTGGTCCGCAGACACCGCTGT|TTAAAGCCGTAGTGAGCCGTATTGTACTGC
GGGCGGACCACTCGTCGTGGTCCGCAGACA|CGCAGACACCGCTGTTACTGAGCAACTCCT
ATACGTGGTCCGCAGACACCGCTGTTACTG|GGTCCGCAGACACCGCTGTTACTGAGCATT
TCCGCAGACACCGCTGTTACTGAGCAAAAG|GGCTCCGGATAACTCGGGCGGAAGAGCGAT
AATATCTGTGGTGGTCCGCAGACACCGCTG|ACCGCTGTTACTGAGCACGGTTGGCTAGGA
AGGAGACGGTTTGGACCGCGGCGTACTCAT|GATCTCCTACATATGCCGTTAGCTTGCTGC
TATGGCAAGGCTGATTAAATATGTGTCTTT|TACTGAGCATAACACAAGCCGAGTACGCTT
GCGTGTTCGCATGGGGTGGTCCGCAGACAC|TAGGATTTAAAGCCGTAGTGAGCCGTATTG
CCGAGTACGCTTTTATCACAGGTGGTCCGC|GAGCGGGTGGTCCGCAGACACCGCTGTTAC
CAGGCGCCGTGGTCCGCAGACACCGCTGTT|TGGTCCGCAGACACCGCTGTTACTGAGCAC
TCGAAAATAGTGGTCCGCAGACACCGCTGT|GACACCGCTGTTACTGAGCAATACATTGTA
GGAGAGCCCATGAGGATGCCACAGAGTTCT|GGTGGTCCGCAGACACCGCTGTTACTGAGC
ATGGTGGTCCGCAGACACCGCTGTTACTGA|TCCGCAGACACCGCTGTTACTGAGCAAAAG
CCGCTGTTACTGAGCACTGAGCATAGGCAA|TATATTCTCCAGGTACCACCAGGCTTGAAA
ACCGCTGTTACTGAGCAATACATTGTAACC|AATATAGTTATTGACAGAAGCGAGGCTGCG
GCGGACCACTCGTCGTGGTCCGCAGACACC|CAGACACCGCTGTTACTGAGCAACTCCTTG
TTTGGGAACGGAATTCAGTCCTTTAGCAAA|TCAGTAAGACGCCTATCGGCTCTGAGCCTG
TTACTGAGCATTTTCATTGGTAGGATTTAA|GACGGTTTGGACCGCGGCGTACTCATGATA
CCGCAGACACCGCTGTTAGTGGTCCGCAGA|TTACTGAGCACCACTTCTAGAAAGATGTGC
GAATGCACGTTCGAGCTTAAAGCTATAGGA|GGGTTCCTCGTACCAACACTTACAATATCT
GAAAATAGTGGTCCGCAGACACCGCTGTTA|CACCGCTGTTACTGAGCAATACATTGTAAC
AGTGAGCCGTATTGTACTGCATGGAGAGTC|GGGTGTGGTCCGCAGACACCGCTGTTACTG
TAGAAAGATGTGCGGTATATTCTCCAGGTA|GAACGTGTTATGGACTGTCTTAACGACGAT
GACCCGGGTCAGTAAGACGCCTATCGGCTC|ATAAGCCCCACCGTCATCTACTCAGAGACA
CTCCTTGGTGGTCCGCAGACACCGCTGTTA|GCAATCTTTCGCGGAGAGCCCATGAGGATG
TGAGCAAGCTGAGGTATCGGGTTCCTCGTA|GAGAGTCCCGATACTTTTCTCGAAAATAGT
CGGGTGGTCCGCAGACACCGCTGTTACTGA|GAACAAGGCATAGTCAACAACTGTGAGCTT
AGCTAACATCATGGATTTGTATACGGTGCA|ACAGGTGGTCCGCAGACACCGCTGTTAGTG
TTCGCAGCTAACATCATGGATTTGTATACG|TTATCACAGGTGGTCCGCAGACACCGCTGT
GGCTTGAAACTAGGAGGGGTGGTCCGCAGA|TGCGCTGCTGACCCGCTCCTATTGAATAAC
GTGTTATGGACTGTCTTAACGACGATTATG|CGCTGTTACTGAGCACTGCGCGTGTTCGCA
CCACCAGGCTTGAAACTAGGAGGGGTGGTC|TATGTATGCGCTGCTGACCCGCTCCTATTG
GTTACTGAGCAAGCTGAGGTATCGGGTTCC|GCATGGAGAGTCCCGATACTTTTCTCGAAA
CTGAGCATTTTCATTGGTAGGATTTAAAGC|GGTTTGGACCGCGGCGTACTCATGATAGCG
GTCCCGATACTTTTCTCGAAAATAGTGGTC|CTGAGCAGGTCCGCAGACACCGCTGTTACT
GCTGACCCGCTCCTATTGAATAACTTCACG|TCCGCAGACACCGCTGTTACTGAGCAAGCT
AGAACGTGTTATGGACTGTCTTAACGACGA|GACACCGCTGTTACTGAGCACTGCGCGTGT
AGCAACTCCTTGGTGGTCCGCAGACACCGC|CATAGGCAATCTTTCGCGGAGAGCCCATGA
AGTCCCGATACTTTTCTCGAAAATAGTGGT|ACTGAGCAGGTCCGCAGACACCGCTGTTAC
ATTCAGTCCTTTAGCAAATGCACAAACTGG|CTATCGGCTCTGAGCCTGGGGTGCTGTACG
CCAGTTGCCCTCCGTTCGATCTCCTACATA|CGATTCCAGGTGTAAGGGCAGCCTTTGGGA
TGCTGCATGGAAACCGTGACGGTCGGCGGA|TCCTTTAGCAAATGCACAAACTGGAGTGGT
ACGGTTGGCTAGGAGACGGTTTGGACCGCG|CCCTCCGTTCGATCTCCTACATATGCCGTT
CCGTATTGTACTGCATGGAGAGTCCCGATA|GGTCCGCAGACACCGCTGTTACTGAGCAGG
TGTAACCAGTTGCCCTCCGTTCGATCTCCT|GGCTGCGATTCCAGGTGTAAGGGCAGCCTT
CCGTTCGATCTCCTACATATGCCGTTAGCT|GTAAGGGCAGCCTTTGGGAACGGAATTCAG
ATTTCGACCCGGGTCAGTAAGACGCCTATC|CGCGCATAAGCCCCACCGTCATCTACTCAG
ATTCCAGGTGTAAGGGCAGCCTTTGGGAAC|GCATAAGAATTTCGACCCGGGTCAGTAAGA
ACAATATCTGTGGTGGTCCGCAGACACCGC|ACACCGCTGTTACTGAGCACGGTTGGCTAG
GGAATTCAGTCCTTTAGCAAATGCACAAAC|CGCCTATCGGCTCTGAGCCTGGGGTGCTGT
TGCGGTATATTCTCCAGGTACCACCAGGCT|TGGACTGTCTTAACGACGATTATGTATGCG
GAGGCTGCGATTCCAGGTGTAAGGGCAGCC|TGAGAATGCGCATAAGAATTTCGACCCGGG
CGTACCAACACTTACAATATCTGTGGTGGT|TAGTGGTCCGCAGACACCGCTGTTACTGAG
TTACTGAGCAAAATACGAACAAGGCATAGT|TGCGGTGAATGCACGTTCGAGCTTAAAGCT
TACTGAGCACTGAGCATAGGCAATCTTTCG|TCCAGGTACCACCAGGCTTGAAACTAGGAG
TGAGCATTTTCATTGGTAGGATTTAAAGCC|GTTTGGACCGCGGCGTACTCATGATAGCGA
AACTAGGAGGGGTGGTCCGCAGACACCGCT|CTGACCCGCTCCTATTGAATAACTTCACGG
TGGAAACCGTGACGGTCGGCGGATGGTGGT|GCAAATGCACAAACTGGAGTGGTCCGCAGA
TCCTATTGAATAACTTCACGGATGCGGTGA|CCGCTGTTACTGAGCAAGCTGAGGTATCGG
GCAGACACCGCTGTTACTGAGCACTGCGCG|ACCGCTGTTACTGAGCATTTTCATTGGTAG
TTTAAAGCCGTAGTGAGCCGTATTGTACTG|TGATAGCGAGAGGGTGTGGTCCGCAGACAC
CACAAGCCGAGTACGCTTTTATCACAGGTG|CTGACGGAGCGGGTGGTCCGCAGACACCGC
AGGATGCCACAGAGTTCTGACGGAGCGGGT|ACACCGCTGTTACTGAGCAAAATACGAACA
GTACCAACACTTACAATATCTGTGGTGGTC|AGTGGTCCGCAGACACCGCTGTTACTGAGC
GTACGCTTTTATCACAGGTGGTCCGCAGAC|GGGTGGTCCGCAGACACCGCTGTTACTGAG
GTTCTGACGGAGCGGGTGGTCCGCAGACAC|TGAGCAAAATACGAACAAGGCATAGTCAAC
ATATTCTCCAGGTACCACCAGGCTTGAAAC|GTCTTAACGACGATTATGTATGCGCTGCTG
GAGGGTGTGGTCCGCAGACACCGCTGTTAC|CGTGACGGTCGGCGGATGGTGGTCCGCAGA
AGGGCAGCCTTTGGGAACGGAATTCAGTCC|CGACCCGGGTCAGTAAGACGCCTATCGGCT
GGATGCCACAGAGTTCTGACGGAGCGGGTG|CACCGCTGTTACTGAGCAAAATACGAACAA
TAACACAAGCCGAGTACGCTTTTATCACAG|GTTCTGACGGAGCGGGTGGTCCGCAGACAC
CCGCTGTTACTGAGCAGGTCCGCAGACACC|GGTCCGCAGACACCGCTGTTACTGAGCAAT
GGCGCCGTGGTCCGCAGACACCGCTGTTAC|GTCCGCAGACACCGCTGTTACTGAGCACTG
AACGTGTTATGGACTGTCTTAACGACGATT|CACCGCTGTTACTGAGCACTGCGCGTGTTC
CAATATAGTTATTGACAGAAGCGAGGCTGC|GTTGAACGATCTACTCTGGCCATGAGAATG
CCGCTCCTATTGAATAACTTCACGGATGCG|GACACCGCTGTTACTGAGCAAGCTGAGGTA
GATGCGGTGAATGCACGTTCGAGCTTAAAG|GAGGTATCGGGTTCCTCGTACCAACACTTA
AATGCGCATAAGAATTTCGACCCGGGTCAG|CGTCATTGCTATTCGCGCATAAGCCCCACC
GATACTTTTCTCGAAAATAGTGGTCCGCAG|CAGGTCCGCAGACACCGCTGTTACTGAGCA
TTAGCAAATGCACAAACTGGAGTGGTCCGC|TGAGCCTGGGGTGCTGTACGCACATGGCTC
AATTTCGACCCGGGTCAGTAAGACGCCTAT|TCGCGCATAAGCCCCACCGTCATCTACTCA
TCCGCAGACACCGCTGTTAGTGGTCCGCAG|GTTACTGAGCACCACTTCTAGAAAGATGTG
TTTCGCAGCTAACATCATGGATTTGTATAC|TTTATCACAGGTGGTCCGCAGACACCGCTG
ATCATGGATTTGTATACGGTGCAGGCGCCG|GTCCGCAGACACCGCTGTTAGTGGTCCGCA
TTGGTGGTCCGCAGACACCGCTGTTACTGA|TCTTTCGCGGAGAGCCCATGAGGATGCCAC
TTTTCATTGGTAGGATTTAAAGCCGTAGTG|ACCGCGGCGTACTCATGATAGCGAGAGGGT
TGAACGATCTACTCTGGCCATGAGAATGCG|TTCCACTTGGGGCAAAACCGTTGACGTCAT
TGTTACTGAGCAAAAGGGTTGAACGATCTA|CGGGCGGAAGAGCGATCTATTCCACTTGGG
CGCGGCGTACTCATGATAGCGAGAGGGTGT|CGTTAGCTTGCTGCATGGAAACCGTGACGG
AGACACCGCTGTTACTGAGCACTGAGCATA|TGCGGTATATTCTCCAGGTACCACCAGGCT
AGCAAATGCACAAACTGGAGTGGTCCGCAG|AGCCTGGGGTGCTGTACGCACATGGCTCCG
TCTCGAAAATAGTGGTCCGCAGACACCGCT|CAGACACCGCTGTTACTGAGCAATACATTG
ATGATAATACGTGGTCCGCAGACACCGCTG|TGTGGTGGTCCGCAGACACCGCTGTTACTG
TTAGCACCACAGAACGTGTTATGGACTGTC|GTGGTCCGCAGACACCGCTGTTACTGAGCA
ATTAAATATGTGTCTTTTTCGCAGCTAACA|ACAAGCCGAGTACGCTTTTATCACAGGTGG
CTGCATGGAGAGTCCCGATACTTTTCTCGA|CACCGCTGTTACTGAGCAGGTCCGCAGACA
CTGTTACTGAGCACCACTTCTAGAAAGATG|CTGTGAGCTTTAGCACCACAGAACGTGTTA
TGCCCTCCGTTCGATCTCCTACATATGCCG|CCAGGTGTAAGGGCAGCCTTTGGGAACGGA
AGCATTTTCATTGGTAGGATTTAAAGCCGT|TTGGACCGCGGCGTACTCATGATAGCGAGA
GCTCCTATTGAATAACTTCACGGATGCGGT|CACCGCTGTTACTGAGCAAGCTGAGGTATC
GCCTTTGGGAACGGAATTCAGTCCTTTAGC|GGGTCAGTAAGACGCCTATCGGCTCTGAGC
GGCTAGGAGACGGTTTGGACCGCGGCGTAC|GTTCGATCTCCTACATATGCCGTTAGCTTG
TGATTAAATATGTGTCTTTTTCGCAGCTAA|ACACAAGCCGAGTACGCTTTTATCACAGGT
CTGTTACTGAGCACGGTTGGCTAGGAGACG|TGTAACCAGTTGCCCTCCGTTCGATCTCCT
CTGAGGTATCGGGTTCCTCGTACCAACACT|CGATACTTTTCTCGAAAATAGTGGTCCGCA
TAGTGAGCCGTATTGTACTGCATGGAGAGT|AGGGTGTGGTCCGCAGACACCGCTGTTACT
ACCGCTGTTACTGAGCAAAAGGGTTGAACG|TAACTCGGGCGGAAGAGCGATCTATTCCAC
CGGATGGTGGTCCGCAGACACCGCTGTTAC|TGGTCCGCAGACACCGCTGTTACTGAGCAA
CCACTCGTCGTGGTCCGCAGACACCGCTGT|ACCGCTGTTACTGAGCAACTCCTTGGTGGT
CCTTTGGGAACGGAATTCAGTCCTTTAGCA|GGTCAGTAAGACGCCTATCGGCTCTGAGCC
CCAGGTGTAAGGGCAGCCTTTGGGAACGGA|TAAGAATTTCGACCCGGGTCAGTAAGACGC
TTGGTAGGATTTAAAGCCGTAGTGAGCCGT|GCGTACTCATGATAGCGAGAGGGTGTGGTC
GGTTTGGACCGCGGCGTACTCATGATAGCG|TACATATGCCGTTAGCTTGCTGCATGGAAA
CGCTGTTACTGAGCATAACACAAGCCGAGT|TGAGGATGCCACAGAGTTCTGACGGAGCGG
TATCACAGGTGGTCCGCAGACACCGCTGTT|GCAGACACCGCTGTTACTGAGCACCACTTC
GGTCCGCAGACACCGCTGTTACTGAGCACT|CAGACACCGCTGTTACTGAGCATTTTCATT
GAAACCGTGACGGTCGGCGGATGGTGGTCC|AAATGCACAAACTGGAGTGGTCCGCAGACA
CGTATTGTACTGCATGGAGAGTCCCGATAC|GTCCGCAGACACCGCTGTTACTGAGCAGGT
GGTCCGCAGACACCGCTGTTACTGAGCAAC|ACACCGCTGTTACTGAGCACTGAGCATAGG
TTACTGAGCATAACACAAGCCGAGTACGCT|ATGCCACAGAGTTCTGACGGAGCGGGTGGT
CGCTTTTATCACAGGTGGTCCGCAGACACC|TGGTCCGCAGACACCGCTGTTACTGAGCAC
CCCTCCGTTCGATCTCCTACATATGCCGTT|AGGTGTAAGGGCAGCCTTTGGGAACGGAAT
TGCAGGCGCCGTGGTCCGCAGACACCGCTG|AGTGGTCCGCAGACACCGCTGTTACTGAGC
AGGGTTGAACGATCTACTCTGGCCATGAGA|ATCTATTCCACTTGGGGCAAAACCGTTGAC
ACTGAGCATTTTCATTGGTAGGATTTAAAG|CGGTTTGGACCGCGGCGTACTCATGATAGC
AAAGCCGTAGTGAGCCGTATTGTACTGCAT|TAGCGAGAGGGTGTGGTCCGCAGACACCGC
GGTGTAAGGGCAGCCTTTGGGAACGGAATT|GAATTTCGACCCGGGTCAGTAAGACGCCTA
AGAGTTCTGACGGAGCGGGTGGTCCGCAGA|TACTGAGCAAAATACGAACAAGGCATAGTC
CAGACACCGCTGTTACTGAGCAAAATACGA|TAACTTCACGGATGCGGTGAATGCACGTTC
CAGACACCGCTGTTACTGAGCACTGCGCGT|CCGCTGTTACTGAGCATTTTCATTGGTAGG
ACAAACTGGAGTGGTCCGCAGACACCGCTG|TGCTGTACGCACATGGCTCCGGATAACTCG
ATATGCCGTTAGCTTGCTGCATGGAAACCG|GGAACGGAATTCAGTCCTTTAGCAAATGCA
ACTGAGCAATATAGTTATTGACAGAAGCGA|AAAAGGGTTGAACGATCTACTCTGGCCATG
CCAACACTTACAATATCTGTGGTGGTCCGC|GGTCCGCAGACACCGCTGTTACTGAGCACG
TCTGGCCATGAGAATGCGCATAAGAATTTC|CAAAACCGTTGACGTCATTGCTATTCGCGC
CACCGCTGTTACTGAGCAGCTTGTCTATGG|CTTGGTGGTCCGCAGACACCGCTGTTACTG
AAAATACGAACAAGGCATAGTCAACAACTG|TGCACGTTCGAGCTTAAAGCTATAGGATGA
GAGCATTTTCATTGGTAGGATTTAAAGCCG|TTTGGACCGCGGCGTACTCATGATAGCGAG
GGTCCGCAGACACCGCTGTTACTGAGCAAT|AGACACCGCTGTTACTGAGCAAAAGGGTTG
TCCGCAGACACCGCTGTTACTGAGCAAAAT|TGAATAACTTCACGGATGCGGTGAATGCAC
ACCGCTGTTACTGAGCAGCTTGTCTATGGC|TTGGTGGTCCGCAGACACCGCTGTTACTGA
ATGTATGCGCTGCTGACCCGCTCCTATTGA|GCATGGGGTGGTCCGCAGACACCGCTGTTA
CGCAGCTAACATCATGGATTTGTATACGGT|ATCACAGGTGGTCCGCAGACACCGCTGTTA
GCAAGCTGAGGTATCGGGTTCCTCGTACCA|AGTCCCGATACTTTTCTCGAAAATAGTGGT
GCTGTTAGTGGTCCGCAGACACCGCTGTTA|CACTTCTAGAAAGATGTGCGGTATATTCTC
CGGATGCGGTGAATGCACGTTCGAGCTTAA|CTGAGGTATCGGGTTCCTCGTACCAACACT
GCGCGTGTTCGCATGGGGTGGTCCGCAGAC|GGTAGGATTTAAAGCCGTAGTGAGCCGTAT
ACGATCTACTCTGGCCATGAGAATGCGCAT|CACTTGGGGCAAAACCGTTGACGTCATTGC
ATGATAGCGAGAGGGTGTGGTCCGCAGACA|GCATGGAAACCGTGACGGTCGGCGGATGGT
CTGAGCATAGGCAATCTTTCGCGGAGAGCC|CACCAGGCTTGAAACTAGGAGGGGTGGTCC
CCATGAGGATGCCACAGAGTTCTGACGGAG|CGCAGACACCGCTGTTACTGAGCAAAATAC
CGGGTTCCTCGTACCAACACTTACAATATC|TCTCGAAAATAGTGGTCCGCAGACACCGCT
ATGGATTTGTATACGGTGCAGGCGCCGTGG|CGCAGACACCGCTGTTAGTGGTCCGCAGAC
CTGTTACTGAGCACTGCGCGTGTTCGCATG|CTGAGCATTTTCATTGGTAGGATTTAAAGC
CTAGGAGGGGTGGTCCGCAGACACCGCTGT|GACCCGCTCCTATTGAATAACTTCACGGAT
GGTCCGCAGACACCGCTGTTACTGAGCACT|AAAGATGTGCGGTATATTCTCCAGGTACCA
GCCATGAGAATGCGCATAAGAATTTCGACC|ACCGTTGACGTCATTGCTATTCGCGCATAA
GACACCGCTGTTACTGAGCAAAATACGAAC|ACTTCACGGATGCGGTGAATGCACGTTCGA
GTGGTCCGCAGACACCGCTGTTACTGAGCA|AGACACCGCTGTTACTGAGCACTGAGCATA
TGAGCCGTATTGTACTGCATGGAGAGTCCC|GTGTGGTCCGCAGACACCGCTGTTACTGAG
TCCCGATACTTTTCTCGAAAATAGTGGTCC|TGAGCAGGTCCGCAGACACCGCTGTTACTG
GACACCGCTGTTACTGAGCATAACACAAGC|GCCCATGAGGATGCCACAGAGTTCTGACGG
ATCGGGTTCCTCGTACCAACACTTACAATA|TTTCTCGAAAATAGTGGTCCGCAGACACCG
TCCGCAGACACCGCTGTTACTGAGCATAAC|CGGAGAGCCCATGAGGATGCCACAGAGTTC
CACCAGGCTTGAAACTAGGAGGGGTGGTCC|ATGTATGCGCTGCTGACCCGCTCCTATTGA
CGCTGTTACTGAGCACTGCGCGTGTTCGCA|TACTGAGCATTTTCATTGGTAGGATTTAAA
ACGACGATTATGTATGCGCTGCTGACCCGC|CGCGTGTTCGCATGGGGTGGTCCGCAGACA
AGCACTGAGCATAGGCAATCTTTCGCGGAG|GTACCACCAGGCTTGAAACTAGGAGGGGTG
CTTTTATCACAGGTGGTCCGCAGACACCGC|GTCCGCAGACACCGCTGTTACTGAGCACCA
TTTAGCACCACAGAACGTGTTATGGACTGT|CGTGGTCCGCAGACACCGCTGTTACTGAGC
CCGCTGTTACTGAGCATTTTCATTGGTAGG|CTAGGAGACGGTTTGGACCGCGGCGTACTC
CCGCAGACACCGCTGTTACTGAGCACGGTT|TGAGCAATACATTGTAACCAGTTGCCCTCC
CACCGCTGTTACTGAGCACTGCGCGTGTTC|TGTTACTGAGCATTTTCATTGGTAGGATTT
CGCTGTTACTGAGCAAAATACGAACAAGGC|ACGGATGCGGTGAATGCACGTTCGAGCTTA
GTAACCAGTTGCCCTCCGTTCGATCTCCTA|GCTGCGATTCCAGGTGTAAGGGCAGCCTTT
ATAACACAAGCCGAGTACGCTTTTATCACA|AGTTCTGACGGAGCGGGTGGTCCGCAGACA
GCCGAGTACGCTTTTATCACAGGTGGTCCG|GGAGCGGGTGGTCCGCAGACACCGCTGTTA
GGCGGATGGTGGTCCGCAGACACCGCTGTT|AGTGGTCCGCAGACACCGCTGTTACTGAGC
CGCGTGTTCGCATGGGGTGGTCCGCAGACA|GTAGGATTTAAAGCCGTAGTGAGCCGTATT
CGGTGCAGGCGCCGTGGTCCGCAGACACCG|GTTAGTGGTCCGCAGACACCGCTGTTACTG
TTACTGAGCAGGTCCGCAGACACCGCTGTT|CAGACACCGCTGTTACTGAGCAATATAGTT
GCGAGGCTGCGATTCCAGGTGTAAGGGCAG|CATGAGAATGCGCATAAGAATTTCGACCCG
ACTGTGAGCTTTAGCACCACAGAACGTGTT|ATGATAATACGTGGTCCGCAGACACCGCTG
CCAGGTACCACCAGGCTTGAAACTAGGAGG|CGACGATTATGTATGCGCTGCTGACCCGCT
AACAAGGCATAGTCAACAACTGTGAGCTTT|CGAGCTTAAAGCTATAGGATGATAATACGT
ATCACAGGTGGTCCGCAGACACCGCTGTTA|CAGACACCGCTGTTACTGAGCACCACTTCT
CATGGAAACCGTGACGGTCGGCGGATGGTG|TAGCAAATGCACAAACTGGAGTGGTCCGCA
CCGCTGTTACTGAGCAAAATACGAACAAGG|CACGGATGCGGTGAATGCACGTTCGAGCTT
CAGGTGGTCCGCAGACACCGCTGTTAGTGG|CACCGCTGTTACTGAGCACCACTTCTAGAA
TCCGCAGACACCGCTGTTACTGAGCAACTC|ACCGCTGTTACTGAGCACTGAGCATAGGCA
ATAGTCAACAACTGTGAGCTTTAGCACCAC|AAGCTATAGGATGATAATACGTGGTCCGCA
ACTGAGCACTGCGCGTGTTCGCATGGGGTG|CATTTTCATTGGTAGGATTTAAAGCCGTAG
GCTGATTAAATATGTGTCTTTTTCGCAGCT|TAACACAAGCCGAGTACGCTTTTATCACAG
GGTGGTCCGCAGACACCGCTGTTAGTGGTC|CCGCTGTTACTGAGCACCACTTCTAGAAAG
CGTAGTGAGCCGTATTGTACTGCATGGAGA|AGAGGGTGTGGTCCGCAGACACCGCTGTTA
ACTCCTTGGTGGTCCGCAGACACCGCTGTT|GGCAATCTTTCGCGGAGAGCCCATGAGGAT
GAAACTAGGAGGGGTGGTCCGCAGACACCG|TGCTGACCCGCTCCTATTGAATAACTTCAC
TGTGGTGGTCCGCAGACACCGCTGTTACTG|GTTACTGAGCACGGTTGGCTAGGAGACGGT
CAGACACCGCTGTTACTGAGCAAAAGGGTT|CCGGATAACTCGGGCGGAAGAGCGATCTAT
GGGTGGTCCGCAGACACCGCTGTTACTGAG|TCCTATTGAATAACTTCACGGATGCGGTGA
TACATTGTAACCAGTTGCCCTCCGTTCGAT|AGCGAGGCTGCGATTCCAGGTGTAAGGGCA
GTTACTGAGCAAAATACGAACAAGGCATAG|ATGCGGTGAATGCACGTTCGAGCTTAAAGC
TTCGCATGGGGTGGTCCGCAGACACCGCTG|TTTAAAGCCGTAGTGAGCCGTATTGTACTG
CTCGAAAATAGTGGTCCGCAGACACCGCTG|AGACACCGCTGTTACTGAGCAATACATTGT
TGCGATTCCAGGTGTAAGGGCAGCCTTTGG|ATGCGCATAAGAATTTCGACCCGGGTCAGT
GGTGGTCCGCAGACACCGCTGTTACTGAGC|CGCAGACACCGCTGTTACTGAGCAAAAGGG
CGCAGACACCGCTGTTACTGAGCATTTTCA|ACGGTTGGCTAGGAGACGGTTTGGACCGCG
AGGTCCGCAGACACCGCTGTTACTGAGCAA|CTGTTACTGAGCAATATAGTTATTGACAGA
GAGCAGGTCCGCAGACACCGCTGTTACTGA|ACCGCTGTTACTGAGCAATATAGTTATTGA
AAAGCTATAGGATGATAATACGTGGTCCGC|CTTACAATATCTGTGGTGGTCCGCAGACAC
AGGATGATAATACGTGGTCCGCAGACACCG|ATCTGTGGTGGTCCGCAGACACCGCTGTTA
TCCAGGTGTAAGGGCAGCCTTTGGGAACGG|ATAAGAATTTCGACCCGGGTCAGTAAGACG
ACCACCAGGCTTGAAACTAGGAGGGGTGGT|TTATGTATGCGCTGCTGACCCGCTCCTATT
GGGAACGGAATTCAGTCCTTTAGCAAATGC|GTAAGACGCCTATCGGCTCTGAGCCTGGGG
GCTGTTACTGAGCACCACTTCTAGAAAGAT|ACTGTGAGCTTTAGCACCACAGAACGTGTT
AGGTGGTCCGCAGACACCGCTGTTAGTGGT|ACCGCTGTTACTGAGCACCACTTCTAGAAA
CTTTTCTCGAAAATAGTGGTCCGCAGACAC|TCCGCAGACACCGCTGTTACTGAGCAATAC
ACAGAGTTCTGACGGAGCGGGTGGTCCGCA|GTTACTGAGCAAAATACGAACAAGGCATAG
CGAGGCTGCGATTCCAGGTGTAAGGGCAGC|ATGAGAATGCGCATAAGAATTTCGACCCGG
GCTTGCTGCATGGAAACCGTGACGGTCGGC|CAGTCCTTTAGCAAATGCACAAACTGGAGT
GCTAACATCATGGATTTGTATACGGTGCAG|CAGGTGGTCCGCAGACACCGCTGTTAGTGG
TCATGGATTTGTATACGGTGCAGGCGCCGT|TCCGCAGACACCGCTGTTAGTGGTCCGCAG
ACTGTCTTAACGACGATTATGTATGCGCTG|TGAGCACTGCGCGTGTTCGCATGGGGTGGT
GTTACTGAGCACTGAGCATAGGCAATCTTT|TCTCCAGGTACCACCAGGCTTGAAACTAGG
GGAGACGGTTTGGACCGCGGCGTACTCATG|ATCTCCTACATATGCCGTTAGCTTGCTGCA
CCTACATATGCCGTTAGCTTGCTGCATGGA|CTTTGGGAACGGAATTCAGTCCTTTAGCAA
TTGGACCGCGGCGTACTCATGATAGCGAGA|ATATGCCGTTAGCTTGCTGCATGGAAACCG
ATATGTGTCTTTTTCGCAGCTAACATCATG|CCGAGTACGCTTTTATCACAGGTGGTCCGC
AGACACCGCTGTTACTGAGCACCACTTCTA|GTCAACAACTGTGAGCTTTAGCACCACAGA
CTGAGCAGCTTGTCTATGGCAAGGCTGATT|GCAGACACCGCTGTTACTGAGCATAACACA
CGGTATATTCTCCAGGTACCACCAGGCTTG|GACTGTCTTAACGACGATTATGTATGCGCT
ATGAGAATGCGCATAAGAATTTCGACCCGG|GTTGACGTCATTGCTATTCGCGCATAAGCC
CATGATAGCGAGAGGGTGTGGTCCGCAGAC|TGCATGGAAACCGTGACGGTCGGCGGATGG
GTTACTGAGCATTTTCATTGGTAGGATTTA|AGACGGTTTGGACCGCGGCGTACTCATGAT
GAGGATGCCACAGAGTTCTGACGGAGCGGG|GACACCGCTGTTACTGAGCAAAATACGAAC
AGCTATAGGATGATAATACGTGGTCCGCAG|TACAATATCTGTGGTGGTCCGCAGACACCG
GGCATAGTCAACAACTGTGAGCTTTAGCAC|TTAAAGCTATAGGATGATAATACGTGGTCC
CACCGCTGTTACTGAGCATTTTCATTGGTA|GGCTAGGAGACGGTTTGGACCGCGGCGTAC
ACTGAGCAACTCCTTGGTGGTCCGCAGACA|TGAGCATAGGCAATCTTTCGCGGAGAGCCC
CGAGAGGGTGTGGTCCGCAGACACCGCTGT|AACCGTGACGGTCGGCGGATGGTGGTCCGC
ACAACTGTGAGCTTTAGCACCACAGAACGT|AGGATGATAATACGTGGTCCGCAGACACCG
AATATGTGTCTTTTTCGCAGCTAACATCAT|GCCGAGTACGCTTTTATCACAGGTGGTCCG
TGGACTGTCTTAACGACGATTATGTATGCG|TACTGAGCACTGCGCGTGTTCGCATGGGGT
GAGGGGTGGTCCGCAGACACCGCTGTTACT|CGCTCCTATTGAATAACTTCACGGATGCGG
TATTGAATAACTTCACGGATGCGGTGAATG|CTGTTACTGAGCAAGCTGAGGTATCGGGTT
CTTCTAGAAAGATGTGCGGTATATTCTCCA|CACAGAACGTGTTATGGACTGTCTTAACGA
ATACTTTTCTCGAAAATAGTGGTCCGCAGA|AGGTCCGCAGACACCGCTGTTACTGAGCAA
GGCTGATTAAATATGTGTCTTTTTCGCAGC|ATAACACAAGCCGAGTACGCTTTTATCACA
CCGCTGTTACTGAGCAAGCTGAGGTATCGG|GTACTGCATGGAGAGTCCCGATACTTTTCT
TATGTGTCTTTTTCGCAGCTAACATCATGG|CGAGTACGCTTTTATCACAGGTGGTCCGCA
TTACTGAGCACCACTTCTAGAAAGATGTGC|TGAGCTTTAGCACCACAGAACGTGTTATGG
GCATGGAAACCGTGACGGTCGGCGGATGGT|TTAGCAAATGCACAAACTGGAGTGGTCCGC
TACTTTTCTCGAAAATAGTGGTCCGCAGAC|GGTCCGCAGACACCGCTGTTACTGAGCAAT
ACTGAGCACGGTTGGCTAGGAGACGGTTTG|CCAGTTGCCCTCCGTTCGATCTCCTACATA
CCACTTCTAGAAAGATGTGCGGTATATTCT|CACCACAGAACGTGTTATGGACTGTCTTAA
TGAGGTATCGGGTTCCTCGTACCAACACTT|GATACTTTTCTCGAAAATAGTGGTCCGCAG
GGTGGTCCGCAGACACCGCTGTTACTGAGC|ACAAGGCATAGTCAACAACTGTGAGCTTTA
GTGCGGTATATTCTCCAGGTACCACCAGGC|ATGGACTGTCTTAACGACGATTATGTATGC
TTATGGACTGTCTTAACGACGATTATGTAT|TGTTACTGAGCACTGCGCGTGTTCGCATGG
TACTCATGATAGCGAGAGGGTGTGGTCCGC|TTGCTGCATGGAAACCGTGACGGTCGGCGG
CTGTGAGCTTTAGCACCACAGAACGTGTTA|TGATAATACGTGGTCCGCAGACACCGCTGT
CGCAGACACCGCTGTTACTGAGCACCACTT|ATAGTCAACAACTGTGAGCTTTAGCACCAC
TTCTCGAAAATAGTGGTCCGCAGACACCGC|GCAGACACCGCTGTTACTGAGCAATACATT
TGAGAATGCGCATAAGAATTTCGACCCGGG|TTGACGTCATTGCTATTCGCGCATAAGCCC
CACCGCTGTTACTGAGCATAACACAAGCCG|CCATGAGGATGCCACAGAGTTCTGACGGAG
TGGTCCGCAGACACCGCTGTTACTGAGCAC|GCAGACACCGCTGTTACTGAGCATTTTCAT
TACTGAGCAGCTTGTCTATGGCAAGGCTGA|CCGCAGACACCGCTGTTACTGAGCATAACA
GGCGTACTCATGATAGCGAGAGGGTGTGGT|TAGCTTGCTGCATGGAAACCGTGACGGTCG
TACTGAGCACTGCGCGTGTTCGCATGGGGT|GCATTTTCATTGGTAGGATTTAAAGCCGTA
ACATTGTAACCAGTTGCCCTCCGTTCGATC|GCGAGGCTGCGATTCCAGGTGTAAGGGCAG
GCATAGGCAATCTTTCGCGGAGAGCCCATG|AGGCTTGAAACTAGGAGGGGTGGTCCGCAG
TAACGACGATTATGTATGCGCTGCTGACCC|TGCGCGTGTTCGCATGGGGTGGTCCGCAGA
ATACATTGTAACCAGTTGCCCTCCGTTCGA|AAGCGAGGCTGCGATTCCAGGTGTAAGGGC
AGTTGCCCTCCGTTCGATCTCCTACATATG|ATTCCAGGTGTAAGGGCAGCCTTTGGGAAC
ACACCGCTGTTACTGAGCACTGCGCGTGTT|CTGTTACTGAGCATTTTCATTGGTAGGATT
CTTAACGACGATTATGTATGCGCTGCTGAC|ACTGCGCGTGTTCGCATGGGGTGGTCCGCA
GTTGCCCTCCGTTCGATCTCCTACATATGC|TTCCAGGTGTAAGGGCAGCCTTTGGGAACG
TGATAGCGAGAGGGTGTGGTCCGCAGACAC|CATGGAAACCGTGACGGTCGGCGGATGGTG
TACGTGGTCCGCAGACACCGCTGTTACTGA|GTCCGCAGACACCGCTGTTACTGAGCATTT
TGTTACTGAGCACTGAGCATAGGCAATCTT|TTCTCCAGGTACCACCAGGCTTGAAACTAG
CGACCCGGGTCAGTAAGACGCCTATCGGCT|CATAAGCCCCACCGTCATCTACTCAGAGAC
CTGAGCACTGCGCGTGTTCGCATGGGGTGG|ATTTTCATTGGTAGGATTTAAAGCCGTAGT
CCACAGAACGTGTTATGGACTGTCTTAACG|CGCAGACACCGCTGTTACTGAGCACTGCGC
GTGGTCCGCAGACACCGCTGTTACTGAGCA|GCAGACACCGCTGTTACTGAGCAAAAGGGT
GGAGGGGTGGTCCGCAGACACCGCTGTTAC|CCGCTCCTATTGAATAACTTCACGGATGCG
CTGAGCAATATAGTTATTGACAGAAGCGAG|AAAGGGTTGAACGATCTACTCTGGCCATGA
CGATTATGTATGCGCTGCTGACCCGCTCCT|TGTTCGCATGGGGTGGTCCGCAGACACCGC
ATAGTGGTCCGCAGACACCGCTGTTACTGA|GCTGTTACTGAGCAATACATTGTAACCAGT
GGATTTAAAGCCGTAGTGAGCCGTATTGTA|TCATGATAGCGAGAGGGTGTGGTCCGCAGA
TCAGTAAGACGCCTATCGGCTCTGAGCCTG|CACCGTCATCTACTCAGAGACAAGAGTCTA
TTCCAGGTGTAAGGGCAGCCTTTGGGAACG|CATAAGAATTTCGACCCGGGTCAGTAAGAC
TAAGAATTTCGACCCGGGTCAGTAAGACGC|CTATTCGCGCATAAGCCCCACCGTCATCTA
CACAAACTGGAGTGGTCCGCAGACACCGCT|GTGCTGTACGCACATGGCTCCGGATAACTC
CCGCAGACACCGCTGTTACTGAGCAGCTTG|GCAACTCCTTGGTGGTCCGCAGACACCGCT
TTTGTATACGGTGCAGGCGCCGTGGTCCGC|ACACCGCTGTTAGTGGTCCGCAGACACCGC
GTGAATGCACGTTCGAGCTTAAAGCTATAG|TCGGGTTCCTCGTACCAACACTTACAATAT
AGGCTGATTAAATATGTGTCTTTTTCGCAG|CATAACACAAGCCGAGTACGCTTTTATCAC
GCCGTTAGCTTGCTGCATGGAAACCGTGAC|CGGAATTCAGTCCTTTAGCAAATGCACAAA
GTGGTCCGCAGACACCGCTGTTACTGAGCA|CAAGGCATAGTCAACAACTGTGAGCTTTAG
CTGAGCAACTCCTTGGTGGTCCGCAGACAC|GAGCATAGGCAATCTTTCGCGGAGAGCCCA
GGTCCGCAGACACCGCTGTTACTGAGCATT|GAGCACGGTTGGCTAGGAGACGGTTTGGAC
CTTGCTGCATGGAAACCGTGACGGTCGGCG|AGTCCTTTAGCAAATGCACAAACTGGAGTG
AGAGCCCATGAGGATGCCACAGAGTTCTGA|TGGTCCGCAGACACCGCTGTTACTGAGCAA
GAGAGCCCATGAGGATGCCACAGAGTTCTG|GTGGTCCGCAGACACCGCTGTTACTGAGCA
ACAGAACGTGTTATGGACTGTCTTAACGAC|CAGACACCGCTGTTACTGAGCACTGCGCGT
GCTGTTACTGAGCAACTCCTTGGTGGTCCG|GAGCACTGAGCATAGGCAATCTTTCGCGGA
CTGAGCAAAATACGAACAAGGCATAGTCAA|GGTGAATGCACGTTCGAGCTTAAAGCTATA
AAATATGTGTCTTTTTCGCAGCTAACATCA|AGCCGAGTACGCTTTTATCACAGGTGGTCC
TTGAACGATCTACTCTGGCCATGAGAATGC|ATTCCACTTGGGGCAAAACCGTTGACGTCA
TGGTCCGCAGACACCGCTGTTACTGAGCAG|GTCGGCGGATGGTGGTCCGCAGACACCGCT
GTTCGAGCTTAAAGCTATAGGATGATAATA|CGTACCAACACTTACAATATCTGTGGTGGT
GATGATAATACGTGGTCCGCAGACACCGCT|CTGTGGTGGTCCGCAGACACCGCTGTTACT
TAAAGCCGTAGTGAGCCGTATTGTACTGCA|ATAGCGAGAGGGTGTGGTCCGCAGACACCG
TCTATGGCAAGGCTGATTAAATATGTGTCT|GTTACTGAGCATAACACAAGCCGAGTACGC
GACACCGCTGTTACTGAGCACGGTTGGCTA|AATACATTGTAACCAGTTGCCCTCCGTTCG
TTGTACTGCATGGAGAGTCCCGATACTTTT|GCAGACACCGCTGTTACTGAGCAGGTCCGC
AACGACGATTATGTATGCGCTGCTGACCCG|GCGCGTGTTCGCATGGGGTGGTCCGCAGAC
GACACCGCTGTTACTGAGCAGGTCCGCAGA|TGGTGGTCCGCAGACACCGCTGTTACTGAG
TTTCGACCCGGGTCAGTAAGACGCCTATCG|GCGCATAAGCCCCACCGTCATCTACTCAGA
CGTTCGAGCTTAAAGCTATAGGATGATAAT|TCGTACCAACACTTACAATATCTGTGGTGG
AGCTTGTCTATGGCAAGGCTGATTAAATAT|ACCGCTGTTACTGAGCATAACACAAGCCGA
GTGTGGTCCGCAGACACCGCTGTTACTGAG|ACGGTCGGCGGATGGTGGTCCGCAGACACC
GTGACGGTCGGCGGATGGTGGTCCGCAGAC|ACAAACTGGAGTGGTCCGCAGACACCGCTG
GGTAGGATTTAAAGCCGTAGTGAGCCGTAT|GTACTCATGATAGCGAGAGGGTGTGGTCCG
GACACCGCTGTTACTGAGCAAAAGGGTTGA|GGATAACTCGGGCGGAAGAGCGATCTATTC
TAGGATGATAATACGTGGTCCGCAGACACC|TATCTGTGGTGGTCCGCAGACACCGCTGTT
TGTTATGGACTGTCTTAACGACGATTATGT|GCTGTTACTGAGCACTGCGCGTGTTCGCAT
GCTGCGATTCCAGGTGTAAGGGCAGCCTTT|GAATGCGCATAAGAATTTCGACCCGGGTCA
TGCCGTTAGCTTGCTGCATGGAAACCGTGA|ACGGAATTCAGTCCTTTAGCAAATGCACAA
TGTTACTGAGCACTGCGCGTGTTCGCATGG|TGAGCATTTTCATTGGTAGGATTTAAAGCC
CGCAGACACCGCTGTTACTGAGCACTGCGC|CACCGCTGTTACTGAGCATTTTCATTGGTA
GACACCGCTGTTAGTGGTCCGCAGACACCG|GAGCACCACTTCTAGAAAGATGTGCGGTAT
TTGAAACTAGGAGGGGTGGTCCGCAGACAC|GCTGCTGACCCGCTCCTATTGAATAACTTC
AGCCGTATTGTACTGCATGGAGAGTCCCGA|GTGGTCCGCAGACACCGCTGTTACTGAGCA
GAGCACCACTTCTAGAAAGATGTGCGGTAT|TTTAGCACCACAGAACGTGTTATGGACTGT
TCCGCAGACACCGCTGTTACTGAGCACCAC|GCATAGTCAACAACTGTGAGCTTTAGCACC
GCACGGTTGGCTAGGAGACGGTTTGGACCG|TGCCCTCCGTTCGATCTCCTACATATGCCG
TGGCTAGGAGACGGTTTGGACCGCGGCGTA|CGTTCGATCTCCTACATATGCCGTTAGCTT
ACCACTTCTAGAAAGATGTGCGGTATATTC|GCACCACAGAACGTGTTATGGACTGTCTTA
AGACACCGCTGTTACTGAGCAATATAGTTA|GCTGTTACTGAGCAAAAGGGTTGAACGATC
AGCTTGCTGCATGGAAACCGTGACGGTCGG|TCAGTCCTTTAGCAAATGCACAAACTGGAG
ATATAGTTATTGACAGAAGCGAGGCTGCGA|TGAACGATCTACTCTGGCCATGAGAATGCG
AAGGGTTGAACGATCTACTCTGGCCATGAG|GATCTATTCCACTTGGGGCAAAACCGTTGA
CGTACTCATGATAGCGAGAGGGTGTGGTCC|GCTTGCTGCATGGAAACCGTGACGGTCGGC
GCAATATAGTTATTGACAGAAGCGAGGCTG|GGTTGAACGATCTACTCTGGCCATGAGAAT
TCGTGGTCCGCAGACACCGCTGTTACTGAG|TTACTGAGCAACTCCTTGGTGGTCCGCAGA
GACACCGCTGTTACTGAGCAATATAGTTAT|CTGTTACTGAGCAAAAGGGTTGAACGATCT
TGGTCCGCAGACACCGCTGTTACTGAGCAC|AAGGCATAGTCAACAACTGTGAGCTTTAGC
AGACACCGCTGTTACTGAGCAAGCTGAGGT|GTATTGTACTGCATGGAGAGTCCCGATACT
GCTGCATGGAAACCGTGACGGTCGGCGGAT|CCTTTAGCAAATGCACAAACTGGAGTGGTC
ATGCACAAACTGGAGTGGTCCGCAGACACC|GGGGTGCTGTACGCACATGGCTCCGGATAA
GTGGTCCGCAGACACCGCTGTTACTGAGCA|TTCGCGGAGAGCCCATGAGGATGCCACAGA
GTATCGGGTTCCTCGTACCAACACTTACAA|CTTTTCTCGAAAATAGTGGTCCGCAGACAC
TGAGCTTTAGCACCACAGAACGTGTTATGG|TAATACGTGGTCCGCAGACACCGCTGTTAC
GCCCTCCGTTCGATCTCCTACATATGCCGT|CAGGTGTAAGGGCAGCCTTTGGGAACGGAA
AGGAGGGGTGGTCCGCAGACACCGCTGTTA|CCCGCTCCTATTGAATAACTTCACGGATGC
CACCACTTCTAGAAAGATGTGCGGTATATT|AGCACCACAGAACGTGTTATGGACTGTCTT
CGCAGACACCGCTGTTACTGAGCAAAAGGG|CTCCGGATAACTCGGGCGGAAGAGCGATCT
CGTTCGATCTCCTACATATGCCGTTAGCTT|TAAGGGCAGCCTTTGGGAACGGAATTCAGT
CATAAGAATTTCGACCCGGGTCAGTAAGAC|TGCTATTCGCGCATAAGCCCCACCGTCATC
CGCTGTTACTGAGCAACTCCTTGGTGGTCC|TGAGCACTGAGCATAGGCAATCTTTCGCGG
GCGGTATATTCTCCAGGTACCACCAGGCTT|GGACTGTCTTAACGACGATTATGTATGCGC
CACGGTTGGCTAGGAGACGGTTTGGACCGC|GCCCTCCGTTCGATCTCCTACATATGCCGT
CATGGAGAGTCCCGATACTTTTCTCGAAAA|CGCTGTTACTGAGCAGGTCCGCAGACACCG
ACTGAGCAATACATTGTAACCAGTTGCCCT|ATTGACAGAAGCGAGGCTGCGATTCCAGGT
GTGGTCCGCAGACACCGCTGTTACTGAGCA|GTTACTGAGCAATACATTGTAACCAGTTGC
AGTACGCTTTTATCACAGGTGGTCCGCAGA|CGGGTGGTCCGCAGACACCGCTGTTACTGA
ACTTTTCTCGAAAATAGTGGTCCGCAGACA|GTCCGCAGACACCGCTGTTACTGAGCAATA
TTATTGACAGAAGCGAGGCTGCGATTCCAG|ATCTACTCTGGCCATGAGAATGCGCATAAG
CAGGTACCACCAGGCTTGAAACTAGGAGGG|GACGATTATGTATGCGCTGCTGACCCGCTC
ACGGTCGGCGGATGGTGGTCCGCAGACACC|AACTGGAGTGGTCCGCAGACACCGCTGTTA
GCACCACAGAACGTGTTATGGACTGTCTTA|GTCCGCAGACACCGCTGTTACTGAGCACTG
ACACCGCTGTTACTGAGCATAACACAAGCC|CCCATGAGGATGCCACAGAGTTCTGACGGA
GCTTGAAACTAGGAGGGGTGGTCCGCAGAC|GCGCTGCTGACCCGCTCCTATTGAATAACT
ACCGCGGCGTACTCATGATAGCGAGAGGGT|GCCGTTAGCTTGCTGCATGGAAACCGTGAC
ATGGCAAGGCTGATTAAATATGTGTCTTTT|ACTGAGCATAACACAAGCCGAGTACGCTTT
CCGTAGTGAGCCGTATTGTACTGCATGGAG|GAGAGGGTGTGGTCCGCAGACACCGCTGTT
GGTCCGCAGACACCGCTGTTACTGAGCAAT|TGTTACTGAGCAATATAGTTATTGACAGAA
GAGCGGGTGGTCCGCAGACACCGCTGTTAC|TACGAACAAGGCATAGTCAACAACTGTGAG
CGCTGTTACTGAGCAATACATTGTAACCAG|TATAGTTATTGACAGAAGCGAGGCTGCGAT
GTGGTCCGCAGACACCGCTGTTACTGAGCA|GGTCGGCGGATGGTGGTCCGCAGACACCGC
CTAGAAAGATGTGCGGTATATTCTCCAGGT|AGAACGTGTTATGGACTGTCTTAACGACGA
CATAGTCAACAACTGTGAGCTTTAGCACCA|AAAGCTATAGGATGATAATACGTGGTCCGC
GAGGTATCGGGTTCCTCGTACCAACACTTA|ATACTTTTCTCGAAAATAGTGGTCCGCAGA
GCACGTTCGAGCTTAAAGCTATAGGATGAT|TCCTCGTACCAACACTTACAATATCTGTGG
ACACAAGCCGAGTACGCTTTTATCACAGGT|TCTGACGGAGCGGGTGGTCCGCAGACACCG
GACACCGCTGTTACTGAGCATTTTCATTGG|TTGGCTAGGAGACGGTTTGGACCGCGGCGT
GATTTGTATACGGTGCAGGCGCCGTGGTCC|AGACACCGCTGTTAGTGGTCCGCAGACACC
TATCTGTGGTGGTCCGCAGACACCGCTGTT|CGCTGTTACTGAGCACGGTTGGCTAGGAGA
CTATGGCAAGGCTGATTAAATATGTGTCTT|TTACTGAGCATAACACAAGCCGAGTACGCT
TTTTCGCAGCTAACATCATGGATTTGTATA|TTTTATCACAGGTGGTCCGCAGACACCGCT
TAAATATGTGTCTTTTTCGCAGCTAACATC|AAGCCGAGTACGCTTTTATCACAGGTGGTC
TAGCAAATGCACAAACTGGAGTGGTCCGCA|GAGCCTGGGGTGCTGTACGCACATGGCTCC
TAAAGCTATAGGATGATAATACGTGGTCCG|ACTTACAATATCTGTGGTGGTCCGCAGACA
GTTACTGAGCACGGTTGGCTAGGAGACGGT|TAACCAGTTGCCCTCCGTTCGATCTCCTAC
TGCATGGAGAGTCCCGATACTTTTCTCGAA|ACCGCTGTTACTGAGCAGGTCCGCAGACAC
GACCCGCTCCTATTGAATAACTTCACGGAT|GCAGACACCGCTGTTACTGAGCAAGCTGAG
TAGCTTGCTGCATGGAAACCGTGACGGTCG|TTCAGTCCTTTAGCAAATGCACAAACTGGA
AGGTATCGGGTTCCTCGTACCAACACTTAC|TACTTTTCTCGAAAATAGTGGTCCGCAGAC
GCTGTTACTGAGCACTGCGCGTGTTCGCAT|ACTGAGCATTTTCATTGGTAGGATTTAAAG
GCACTGCGCGTGTTCGCATGGGGTGGTCCG|TCATTGGTAGGATTTAAAGCCGTAGTGAGC
TTGGCTAGGAGACGGTTTGGACCGCGGCGT|CCGTTCGATCTCCTACATATGCCGTTAGCT
GTTACTGAGCAGGTCCGCAGACACCGCTGT|GCAGACACCGCTGTTACTGAGCAATATAGT
TGTTAGTGGTCCGCAGACACCGCTGTTACT|CTTCTAGAAAGATGTGCGGTATATTCTCCA
TTCTAGAAAGATGTGCGGTATATTCTCCAG|ACAGAACGTGTTATGGACTGTCTTAACGAC
CACAGAACGTGTTATGGACTGTCTTAACGA|GCAGACACCGCTGTTACTGAGCACTGCGCG
AGAGGGTGTGGTCCGCAGACACCGCTGTTA|CCGTGACGGTCGGCGGATGGTGGTCCGCAG
GCTGTTACTGAGCAAGCTGAGGTATCGGGT|ACTGCATGGAGAGTCCCGATACTTTTCTCG
TGGTCCGCAGACACCGCTGTTACTGAGCAA|AGTGAGCCGTATTGTACTGCATGGAGAGTC
TGAGCAACTCCTTGGTGGTCCGCAGACACC|AGCATAGGCAATCTTTCGCGGAGAGCCCAT
GGTACCACCAGGCTTGAAACTAGGAGGGGT|CGATTATGTATGCGCTGCTGACCCGCTCCT
CTATTGAATAACTTCACGGATGCGGTGAAT|GCTGTTACTGAGCAAGCTGAGGTATCGGGT
GAGCACTGCGCGTGTTCGCATGGGGTGGTC|TTTCATTGGTAGGATTTAAAGCCGTAGTGA
TATACGGTGCAGGCGCCGTGGTCCGCAGAC|CGCTGTTAGTGGTCCGCAGACACCGCTGTT
CGCCGTGGTCCGCAGACACCGCTGTTACTG|CCGCAGACACCGCTGTTACTGAGCACTGAG
GACACCGCTGTTACTGAGCACTGCGCGTGT|GCTGTTACTGAGCATTTTCATTGGTAGGAT
GCGATTCCAGGTGTAAGGGCAGCCTTTGGG|TGCGCATAAGAATTTCGACCCGGGTCAGTA
AGACACCGCTGTTACTGAGCAAAAGGGTTG|CGGATAACTCGGGCGGAAGAGCGATCTATT
TTACTGAGCAACTCCTTGGTGGTCCGCAGA|ACTGAGCATAGGCAATCTTTCGCGGAGAGC
CTGAGCATAACACAAGCCGAGTACGCTTTT|CCACAGAGTTCTGACGGAGCGGGTGGTCCG
CTGACCCGCTCCTATTGAATAACTTCACGG|CCGCAGACACCGCTGTTACTGAGCAAGCTG
CTTTGGGAACGGAATTCAGTCCTTTAGCAA|GTCAGTAAGACGCCTATCGGCTCTGAGCCT
ACAAGGCATAGTCAACAACTGTGAGCTTTA|GAGCTTAAAGCTATAGGATGATAATACGTG
ATTGGTAGGATTTAAAGCCGTAGTGAGCCG|GGCGTACTCATGATAGCGAGAGGGTGTGGT
GAATGCGCATAAGAATTTCGACCCGGGTCA|ACGTCATTGCTATTCGCGCATAAGCCCCAC
GAATAACTTCACGGATGCGGTGAATGCACG|TACTGAGCAAGCTGAGGTATCGGGTTCCTC
GGAGAGTCCCGATACTTTTCTCGAAAATAG|TGTTACTGAGCAGGTCCGCAGACACCGCTG
AATCTTTCGCGGAGAGCCCATGAGGATGCC|AACTAGGAGGGGTGGTCCGCAGACACCGCT
CGTGTTATGGACTGTCTTAACGACGATTAT|CCGCTGTTACTGAGCACTGCGCGTGTTCGC
CACCACAGAACGTGTTATGGACTGTCTTAA|TCCGCAGACACCGCTGTTACTGAGCACTGC
ACACCGCTGTTACTGAGCAAGCTGAGGTAT|ATTGTACTGCATGGAGAGTCCCGATACTTT
TCAGTCCTTTAGCAAATGCACAAACTGGAG|ATCGGCTCTGAGCCTGGGGTGCTGTACGCA
GGTATCGGGTTCCTCGTACCAACACTTACA|ACTTTTCTCGAAAATAGTGGTCCGCAGACA
TACGGTGCAGGCGCCGTGGTCCGCAGACAC|CTGTTAGTGGTCCGCAGACACCGCTGTTAC
GAATTCAGTCCTTTAGCAAATGCACAAACT|GCCTATCGGCTCTGAGCCTGGGGTGCTGTA
CAGAGTTCTGACGGAGCGGGTGGTCCGCAG|TTACTGAGCAAAATACGAACAAGGCATAGT
CTTGTCTATGGCAAGGCTGATTAAATATGT|CGCTGTTACTGAGCATAACACAAGCCGAGT
AAACTGGAGTGGTCCGCAGACACCGCTGTT|CTGTACGCACATGGCTCCGGATAACTCGGG
TAAGGGCAGCCTTTGGGAACGGAATTCAGT|TTCGACCCGGGTCAGTAAGACGCCTATCGG
ATCTGTGGTGGTCCGCAGACACCGCTGTTA|GCTGTTACTGAGCACGGTTGGCTAGGAGAC
GACACCGCTGTTACTGAGCAATACATTGTA|AGCAATATAGTTATTGACAGAAGCGAGGCT
ACCGCTGTTACTGAGCAATATAGTTATTGA|TTACTGAGCAAAAGGGTTGAACGATCTACT
GGGTTCCTCGTACCAACACTTACAATATCT|CTCGAAAATAGTGGTCCGCAGACACCGCTG
ACACCGCTGTTACTGAGCAAAAGGGTTGAA|GATAACTCGGGCGGAAGAGCGATCTATTCC
CTACATATGCCGTTAGCTTGCTGCATGGAA|TTTGGGAACGGAATTCAGTCCTTTAGCAAA
GCAACTCCTTGGTGGTCCGCAGACACCGCT|ATAGGCAATCTTTCGCGGAGAGCCCATGAG
TGAGCAAAAGGGTTGAACGATCTACTCTGG|GAAGAGCGATCTATTCCACTTGGGGCAAAA
CGCAGACACCGCTGTTACTGAGCACGGTTG|GAGCAATACATTGTAACCAGTTGCCCTCCG
TGTTACTGAGCAGCTTGTCTATGGCAAGGC|GGTCCGCAGACACCGCTGTTACTGAGCATA
CCTATTGAATAACTTCACGGATGCGGTGAA|CGCTGTTACTGAGCAAGCTGAGGTATCGGG
AAACCGTGACGGTCGGCGGATGGTGGTCCG|AATGCACAAACTGGAGTGGTCCGCAGACAC
GAGTACGCTTTTATCACAGGTGGTCCGCAG|GCGGGTGGTCCGCAGACACCGCTGTTACTG
GAGCAACTCCTTGGTGGTCCGCAGACACCG|GCATAGGCAATCTTTCGCGGAGAGCCCATG
TTACTGAGCACTGAGCATAGGCAATCTTTC|CTCCAGGTACCACCAGGCTTGAAACTAGGA
AGCCGAGTACGCTTTTATCACAGGTGGTCC|CGGAGCGGGTGGTCCGCAGACACCGCTGTT
CAGTCCTTTAGCAAATGCACAAACTGGAGT|TCGGCTCTGAGCCTGGGGTGCTGTACGCAC
GCGAGAGGGTGTGGTCCGCAGACACCGCTG|AAACCGTGACGGTCGGCGGATGGTGGTCCG
AGCTGAGGTATCGGGTTCCTCGTACCAACA|CCCGATACTTTTCTCGAAAATAGTGGTCCG
TGAGCACCACTTCTAGAAAGATGTGCGGTA|CTTTAGCACCACAGAACGTGTTATGGACTG
CAGGCTTGAAACTAGGAGGGGTGGTCCGCA|TATGCGCTGCTGACCCGCTCCTATTGAATA
GTAGTGAGCCGTATTGTACTGCATGGAGAG|GAGGGTGTGGTCCGCAGACACCGCTGTTAC
CGCAGACACCGCTGTTACTGAGCAATACAT|ACTGAGCAATATAGTTATTGACAGAAGCGA
ATCTTTCGCGGAGAGCCCATGAGGATGCCA|ACTAGGAGGGGTGGTCCGCAGACACCGCTG
TATGTATGCGCTGCTGACCCGCTCCTATTG|CGCATGGGGTGGTCCGCAGACACCGCTGTT
GAGAGTCCCGATACTTTTCTCGAAAATAGT|GTTACTGAGCAGGTCCGCAGACACCGCTGT
GACGATTATGTATGCGCTGCTGACCCGCTC|CGTGTTCGCATGGGGTGGTCCGCAGACACC
TATATTCTCCAGGTACCACCAGGCTTGAAA|TGTCTTAACGACGATTATGTATGCGCTGCT
ACCGCTGTTAGTGGTCCGCAGACACCGCTG|CACCACTTCTAGAAAGATGTGCGGTATATT
GGGTTGAACGATCTACTCTGGCCATGAGAA|TCTATTCCACTTGGGGCAAAACCGTTGACG
AAATACGAACAAGGCATAGTCAACAACTGT|GCACGTTCGAGCTTAAAGCTATAGGATGAT
ACGGAGCGGGTGGTCCGCAGACACCGCTGT|AAATACGAACAAGGCATAGTCAACAACTGT
GCTAGGAGACGGTTTGGACCGCGGCGTACT|TTCGATCTCCTACATATGCCGTTAGCTTGC
TGGTCCGCAGACACCGCTGTTACTGAGCAA|TATTGAATAACTTCACGGATGCGGTGAATG
AGAATTTCGACCCGGGTCAGTAAGACGCCT|ATTCGCGCATAAGCCCCACCGTCATCTACT
TGAGCACTGAGCATAGGCAATCTTTCGCGG|AGGTACCACCAGGCTTGAAACTAGGAGGGG
TACCAACACTTACAATATCTGTGGTGGTCC|GTGGTCCGCAGACACCGCTGTTACTGAGCA
TAGTCAACAACTGTGAGCTTTAGCACCACA|AGCTATAGGATGATAATACGTGGTCCGCAG
AGCATAACACAAGCCGAGTACGCTTTTATC|CAGAGTTCTGACGGAGCGGGTGGTCCGCAG
ACTGAGCATAGGCAATCTTTCGCGGAGAGC|CCACCAGGCTTGAAACTAGGAGGGGTGGTC
CTCATGATAGCGAGAGGGTGTGGTCCGCAG|GCTGCATGGAAACCGTGACGGTCGGCGGAT
TTCGATCTCCTACATATGCCGTTAGCTTGC|AGGGCAGCCTTTGGGAACGGAATTCAGTCC
TTAAATATGTGTCTTTTTCGCAGCTAACAT|CAAGCCGAGTACGCTTTTATCACAGGTGGT
CCCGCTCCTATTGAATAACTTCACGGATGC|AGACACCGCTGTTACTGAGCAAGCTGAGGT
TTTGGACCGCGGCGTACTCATGATAGCGAG|CATATGCCGTTAGCTTGCTGCATGGAAACC
TGCGCGTGTTCGCATGGGGTGGTCCGCAGA|TGGTAGGATTTAAAGCCGTAGTGAGCCGTA
GCAGACACCGCTGTTACTGAGCAATACATT|CTGAGCAATATAGTTATTGACAGAAGCGAG
CGCAGACACCGCTGTTACTGAGCATAACAC|GAGAGCCCATGAGGATGCCACAGAGTTCTG
GTCAGTAAGACGCCTATCGGCTCTGAGCCT|CCACCGTCATCTACTCAGAGACAAGAGTCT
GGGCAGCCTTTGGGAACGGAATTCAGTCCT|GACCCGGGTCAGTAAGACGCCTATCGGCTC
TGATAATACGTGGTCCGCAGACACCGCTGT|GTGGTGGTCCGCAGACACCGCTGTTACTGA
CTGAGCAATACATTGTAACCAGTTGCCCTC|TTGACAGAAGCGAGGCTGCGATTCCAGGTG
TTACTGAGCAATATAGTTATTGACAGAAGC|GCAAAAGGGTTGAACGATCTACTCTGGCCA
ATTGAATAACTTCACGGATGCGGTGAATGC|TGTTACTGAGCAAGCTGAGGTATCGGGTTC
GGCAAGGCTGATTAAATATGTGTCTTTTTC|TGAGCATAACACAAGCCGAGTACGCTTTTA
AGCACGGTTGGCTAGGAGACGGTTTGGACC|TTGCCCTCCGTTCGATCTCCTACATATGCC
TTTAGCAAATGCACAAACTGGAGTGGTCCG|CTGAGCCTGGGGTGCTGTACGCACATGGCT
TGGTCCGCAGACACCGCTGTTACTGAGCAC|GAAAGATGTGCGGTATATTCTCCAGGTACC
CGTGTTCGCATGGGGTGGTCCGCAGACACC|AGGATTTAAAGCCGTAGTGAGCCGTATTGT
TGCCACAGAGTTCTGACGGAGCGGGTGGTC|CGCTGTTACTGAGCAAAATACGAACAAGGC
GCAGCTTGTCTATGGCAAGGCTGATTAAAT|ACACCGCTGTTACTGAGCATAACACAAGCC
TGGAGTGGTCCGCAGACACCGCTGTTACTG|ACGCACATGGCTCCGGATAACTCGGGCGGA
GTCGGCGGATGGTGGTCCGCAGACACCGCT|TGGAGTGGTCCGCAGACACCGCTGTTACTG
TGACGGAGCGGGTGGTCCGCAGACACCGCT|CAAAATACGAACAAGGCATAGTCAACAACT
GCAATCTTTCGCGGAGAGCCCATGAGGATG|GAAACTAGGAGGGGTGGTCCGCAGACACCG
ACTGAGCAAGCTGAGGTATCGGGTTCCTCG|TGGAGAGTCCCGATACTTTTCTCGAAAATA
GATTAAATATGTGTCTTTTTCGCAGCTAAC|CACAAGCCGAGTACGCTTTTATCACAGGTG
CGCATGGGGTGGTCCGCAGACACCGCTGTT|TAAAGCCGTAGTGAGCCGTATTGTACTGCA
CACCGCTGTTACTGAGCACGGTTGGCTAGG|TACATTGTAACCAGTTGCCCTCCGTTCGAT
TGTATACGGTGCAGGCGCCGTGGTCCGCAG|ACCGCTGTTAGTGGTCCGCAGACACCGCTG
AGATGTGCGGTATATTCTCCAGGTACCACC|TGTTATGGACTGTCTTAACGACGATTATGT
AAAATAGTGGTCCGCAGACACCGCTGTTAC|ACCGCTGTTACTGAGCAATACATTGTAACC
CCGGGTCAGTAAGACGCCTATCGGCTCTGA|AGCCCCACCGTCATCTACTCAGAGACAAGA
CGATTCCAGGTGTAAGGGCAGCCTTTGGGA|GCGCATAAGAATTTCGACCCGGGTCAGTAA
AGCAAGCTGAGGTATCGGGTTCCTCGTACC|GAGTCCCGATACTTTTCTCGAAAATAGTGG
AACGGAATTCAGTCCTTTAGCAAATGCACA|AGACGCCTATCGGCTCTGAGCCTGGGGTGC
CGCTGTTACTGAGCAATATAGTTATTGACA|ACTGAGCAAAAGGGTTGAACGATCTACTCT
TCTTAACGACGATTATGTATGCGCTGCTGA|CACTGCGCGTGTTCGCATGGGGTGGTCCGC
TTTTATCACAGGTGGTCCGCAGACACCGCT|TCCGCAGACACCGCTGTTACTGAGCACCAC
CGCAGACACCGCTGTTAGTGGTCCGCAGAC|TACTGAGCACCACTTCTAGAAAGATGTGCG
AGCACCACAGAACGTGTTATGGACTGTCTT|GGTCCGCAGACACCGCTGTTACTGAGCACT
CAGACACCGCTGTTAGTGGTCCGCAGACAC|CTGAGCACCACTTCTAGAAAGATGTGCGGT
GGACTGTCTTAACGACGATTATGTATGCGC|ACTGAGCACTGCGCGTGTTCGCATGGGGTG
GACGGAGCGGGTGGTCCGCAGACACCGCTG|AAAATACGAACAAGGCATAGTCAACAACTG
CTGTTACTGAGCAGGTCCGCAGACACCGCT|CCGCAGACACCGCTGTTACTGAGCAATATA
ATCTCCTACATATGCCGTTAGCTTGCTGCA|CAGCCTTTGGGAACGGAATTCAGTCCTTTA
TGTTACTGAGCAATACATTGTAACCAGTTG|AGTTATTGACAGAAGCGAGGCTGCGATTCC
GAGCCCATGAGGATGCCACAGAGTTCTGAC|GGTCCGCAGACACCGCTGTTACTGAGCAAA
TACTGCATGGAGAGTCCCGATACTTTTCTC|GACACCGCTGTTACTGAGCAGGTCCGCAGA
GAGCAAAAGGGTTGAACGATCTACTCTGGC|AAGAGCGATCTATTCCACTTGGGGCAAAAC
ATGCGCATAAGAATTTCGACCCGGGTCAGT|GTCATTGCTATTCGCGCATAAGCCCCACCG
TCGTACCAACACTTACAATATCTGTGGTGG|ATAGTGGTCCGCAGACACCGCTGTTACTGA
GCGGAGAGCCCATGAGGATGCCACAGAGTT|GGGGTGGTCCGCAGACACCGCTGTTACTGA
TTATCACAGGTGGTCCGCAGACACCGCTGT|CGCAGACACCGCTGTTACTGAGCACCACTT
TCCAGGTACCACCAGGCTTGAAACTAGGAG|ACGACGATTATGTATGCGCTGCTGACCCGC
AGACACCGCTGTTACTGAGCAGCTTGTCTA|CTCCTTGGTGGTCCGCAGACACCGCTGTTA
GCAGACACCGCTGTTAGTGGTCCGCAGACA|ACTGAGCACCACTTCTAGAAAGATGTGCGG
TATTGTACTGCATGGAGAGTCCCGATACTT|CCGCAGACACCGCTGTTACTGAGCAGGTCC
TGAGGATGCCACAGAGTTCTGACGGAGCGG|AGACACCGCTGTTACTGAGCAAAATACGAA
CGGTCGGCGGATGGTGGTCCGCAGACACCG|ACTGGAGTGGTCCGCAGACACCGCTGTTAC
TGTTACTGAGCAAGCTGAGGTATCGGGTTC|TGCATGGAGAGTCCCGATACTTTTCTCGAA
TGACAGAAGCGAGGCTGCGATTCCAGGTGT|ACTCTGGCCATGAGAATGCGCATAAGAATT
CGCTCCTATTGAATAACTTCACGGATGCGG|ACACCGCTGTTACTGAGCAAGCTGAGGTAT
TGAATAACTTCACGGATGCGGTGAATGCAC|TTACTGAGCAAGCTGAGGTATCGGGTTCCT
GTGTCTTTTTCGCAGCTAACATCATGGATT|GTACGCTTTTATCACAGGTGGTCCGCAGAC
GTTACTGAGCAAAAGGGTTGAACGATCTAC|GGGCGGAAGAGCGATCTATTCCACTTGGGG
CGCATAAGAATTTCGACCCGGGTCAGTAAG|ATTGCTATTCGCGCATAAGCCCCACCGTCA
GCCGTGGTCCGCAGACACCGCTGTTACTGA|CGCAGACACCGCTGTTACTGAGCACTGAGC
GGTCCGCAGACACCGCTGTTACTGAGCAGG|TCGGCGGATGGTGGTCCGCAGACACCGCTG
GGAAACCGTGACGGTCGGCGGATGGTGGTC|CAAATGCACAAACTGGAGTGGTCCGCAGAC
GTTACTGAGCACTGCGCGTGTTCGCATGGG|GAGCATTTTCATTGGTAGGATTTAAAGCCG
ACCGCTGTTACTGAGCACGGTTGGCTAGGA|ACATTGTAACCAGTTGCCCTCCGTTCGATC
AATATAGTTATTGACAGAAGCGAGGCTGCG|TTGAACGATCTACTCTGGCCATGAGAATGC
TGCGGTGAATGCACGTTCGAGCTTAAAGCT|GGTATCGGGTTCCTCGTACCAACACTTACA
ACATATGCCGTTAGCTTGCTGCATGGAAAC|TGGGAACGGAATTCAGTCCTTTAGCAAATG
GTCCGCAGACACCGCTGTTACTGAGCAGCT|GAGCAACTCCTTGGTGGTCCGCAGACACCG
ACAGGTGGTCCGCAGACACCGCTGTTAGTG|ACACCGCTGTTACTGAGCACCACTTCTAGA
CACTGCGCGTGTTCGCATGGGGTGGTCCGC|CATTGGTAGGATTTAAAGCCGTAGTGAGCC
GAACGTGTTATGGACTGTCTTAACGACGAT|ACACCGCTGTTACTGAGCACTGCGCGTGTT
GCAGACACCGCTGTTACTGAGCACGGTTGG|AGCAATACATTGTAACCAGTTGCCCTCCGT
GCATAGTCAACAACTGTGAGCTTTAGCACC|TAAAGCTATAGGATGATAATACGTGGTCCG
AGACACCGCTGTTACTGAGCAACTCCTTGG|TGTTACTGAGCACTGAGCATAGGCAATCTT
GCAATACATTGTAACCAGTTGCCCTCCGTT|CAGAAGCGAGGCTGCGATTCCAGGTGTAAG
TATGCCGTTAGCTTGCTGCATGGAAACCGT|GAACGGAATTCAGTCCTTTAGCAAATGCAC
ACATCATGGATTTGTATACGGTGCAGGCGC|TGGTCCGCAGACACCGCTGTTAGTGGTCCG
GTGGTCCGCAGACACCGCTGTTACTGAGCA|CTGAGCACGGTTGGCTAGGAGACGGTTTGG
TGACCCGCTCCTATTGAATAACTTCACGGA|CGCAGACACCGCTGTTACTGAGCAAGCTGA
CAAAATACGAACAAGGCATAGTCAACAACT|ATGCACGTTCGAGCTTAAAGCTATAGGATG
TTACTGAGCACTGCGCGTGTTCGCATGGGG|AGCATTTTCATTGGTAGGATTTAAAGCCGT
CAACTCCTTGGTGGTCCGCAGACACCGCTG|TAGGCAATCTTTCGCGGAGAGCCCATGAGG
CCGCAGACACCGCTGTTACTGAGCATAACA|GGAGAGCCCATGAGGATGCCACAGAGTTCT
ACGTGGTCCGCAGACACCGCTGTTACTGAG|TCCGCAGACACCGCTGTTACTGAGCATTTT
CACTCGTCGTGGTCCGCAGACACCGCTGTT|CCGCTGTTACTGAGCAACTCCTTGGTGGTC
GGTGGTCCGCAGACACCGCTGTTACTGAGC|TTTCGCGGAGAGCCCATGAGGATGCCACAG
ACTGAGCAAAATACGAACAAGGCATAGTCA|CGGTGAATGCACGTTCGAGCTTAAAGCTAT
GGTGTGGTCCGCAGACACCGCTGTTACTGA|GACGGTCGGCGGATGGTGGTCCGCAGACAC
GCAGACACCGCTGTTACTGAGCACTGAGCA|TGTGCGGTATATTCTCCAGGTACCACCAGG
TCCGCAGACACCGCTGTTACTGAGCAATAC|TTACTGAGCAATATAGTTATTGACAGAAGC
TTATGTATGCGCTGCTGACCCGCTCCTATT|TCGCATGGGGTGGTCCGCAGACACCGCTGT
ATTTTCATTGGTAGGATTTAAAGCCGTAGT|GACCGCGGCGTACTCATGATAGCGAGAGGG
GCTGAGGTATCGGGTTCCTCGTACCAACAC|CCGATACTTTTCTCGAAAATAGTGGTCCGC
GTCCGCAGACACCGCTGTTACTGAGCATTT|AGCACGGTTGGCTAGGAGACGGTTTGGACC
ACTTCTAGAAAGATGTGCGGTATATTCTCC|CCACAGAACGTGTTATGGACTGTCTTAACG
TCGCGGAGAGCCCATGAGGATGCCACAGAG|GAGGGGTGGTCCGCAGACACCGCTGTTACT
CTGAGCACCACTTCTAGAAAGATGTGCGGT|GCTTTAGCACCACAGAACGTGTTATGGACT
CGCTGTTAGTGGTCCGCAGACACCGCTGTT|CCACTTCTAGAAAGATGTGCGGTATATTCT
TGAAACTAGGAGGGGTGGTCCGCAGACACC|CTGCTGACCCGCTCCTATTGAATAACTTCA
AAAAGGGTTGAACGATCTACTCTGGCCATG|GCGATCTATTCCACTTGGGGCAAAACCGTT
GTTCGATCTCCTACATATGCCGTTAGCTTG|AAGGGCAGCCTTTGGGAACGGAATTCAGTC
CGCTGTTACTGAGCAAAAGGGTTGAACGAT|ACTCGGGCGGAAGAGCGATCTATTCCACTT
TTCATTGGTAGGATTTAAAGCCGTAGTGAG|CGCGGCGTACTCATGATAGCGAGAGGGTGT
TCGTCGTGGTCCGCAGACACCGCTGTTACT|CTGTTACTGAGCAACTCCTTGGTGGTCCGC
TAGCACCACAGAACGTGTTATGGACTGTCT|TGGTCCGCAGACACCGCTGTTACTGAGCAC
GGTTCCTCGTACCAACACTTACAATATCTG|TCGAAAATAGTGGTCCGCAGACACCGCTGT
CCTCCGTTCGATCTCCTACATATGCCGTTA|GGTGTAAGGGCAGCCTTTGGGAACGGAATT
ATTGACAGAAGCGAGGCTGCGATTCCAGGT|CTACTCTGGCCATGAGAATGCGCATAAGAA
ATACGGTGCAGGCGCCGTGGTCCGCAGACA|GCTGTTAGTGGTCCGCAGACACCGCTGTTA
CTGTGGTGGTCCGCAGACACCGCTGTTACT|TGTTACTGAGCACGGTTGGCTAGGAGACGG
GTTTGGACCGCGGCGTACTCATGATAGCGA|ACATATGCCGTTAGCTTGCTGCATGGAAAC
TAGGCAATCTTTCGCGGAGAGCCCATGAGG|CTTGAAACTAGGAGGGGTGGTCCGCAGACA
TTACTGAGCAAGCTGAGGTATCGGGTTCCT|CATGGAGAGTCCCGATACTTTTCTCGAAAA
CCTTTAGCAAATGCACAAACTGGAGTGGTC|CTCTGAGCCTGGGGTGCTGTACGCACATGG
CGCAGACACCGCTGTTACTGAGCAATATAG|ACCGCTGTTACTGAGCAAAAGGGTTGAACG
CTGTTACTGAGCAGCTTGTCTATGGCAAGG|TGGTCCGCAGACACCGCTGTTACTGAGCAT
TCAACAACTGTGAGCTTTAGCACCACAGAA|TATAGGATGATAATACGTGGTCCGCAGACA
CGGTTGGCTAGGAGACGGTTTGGACCGCGG|CCTCCGTTCGATCTCCTACATATGCCGTTA
ATGCCGTTAGCTTGCTGCATGGAAACCGTG|AACGGAATTCAGTCCTTTAGCAAATGCACA
ATTTAAAGCCGTAGTGAGCCGTATTGTACT|ATGATAGCGAGAGGGTGTGGTCCGCAGACA
GACGGTCGGCGGATGGTGGTCCGCAGACAC|AAACTGGAGTGGTCCGCAGACACCGCTGTT
TGAGCACTGCGCGTGTTCGCATGGGGTGGT|TTTTCATTGGTAGGATTTAAAGCCGTAGTG
AACCGTGACGGTCGGCGGATGGTGGTCCGC|ATGCACAAACTGGAGTGGTCCGCAGACACC
ATGGAGAGTCCCGATACTTTTCTCGAAAAT|GCTGTTACTGAGCAGGTCCGCAGACACCGC
AGACACCGCTGTTACTGAGCATAACACAAG|AGCCCATGAGGATGCCACAGAGTTCTGACG
GGGGCGGACCACTCGTCGTGGTCCGCAGAC|CCGCAGACACCGCTGTTACTGAGCAACTCC
GGTTGAACGATCTACTCTGGCCATGAGAAT|CTATTCCACTTGGGGCAAAACCGTTGACGT
GTCCGCAGACACCGCTGTTAGTGGTCCGCA|TGTTACTGAGCACCACTTCTAGAAAGATGT
GTCGTGGTCCGCAGACACCGCTGTTACTGA|GTTACTGAGCAACTCCTTGGTGGTCCGCAG
ACGATTATGTATGCGCTGCTGACCCGCTCC|GTGTTCGCATGGGGTGGTCCGCAGACACCG
GACACCGCTGTTACTGAGCAGCTTGTCTAT|TCCTTGGTGGTCCGCAGACACCGCTGTTAC
ACCAACACTTACAATATCTGTGGTGGTCCG|TGGTCCGCAGACACCGCTGTTACTGAGCAC
GTATACGGTGCAGGCGCCGTGGTCCGCAGA|CCGCTGTTAGTGGTCCGCAGACACCGCTGT
TAGTGGTCCGCAGACACCGCTGTTACTGAG|CTAGAAAGATGTGCGGTATATTCTCCAGGT
ACTGAGCATAACACAAGCCGAGTACGCTTT|GCCACAGAGTTCTGACGGAGCGGGTGGTCC
TTAACGACGATTATGTATGCGCTGCTGACC|CTGCGCGTGTTCGCATGGGGTGGTCCGCAG
GCAGGTCCGCAGACACCGCTGTTACTGAGC|CGCTGTTACTGAGCAATATAGTTATTGACA
CAGCCTTTGGGAACGGAATTCAGTCCTTTA|CCGGGTCAGTAAGACGCCTATCGGCTCTGA
CGATCTACTCTGGCCATGAGAATGCGCATA|ACTTGGGGCAAAACCGTTGACGTCATTGCT
GGATGCGGTGAATGCACGTTCGAGCTTAAA|TGAGGTATCGGGTTCCTCGTACCAACACTT
TTTATCACAGGTGGTCCGCAGACACCGCTG|CCGCAGACACCGCTGTTACTGAGCACCACT
CAGCTAACATCATGGATTTGTATACGGTGC|CACAGGTGGTCCGCAGACACCGCTGTTAGT
ATGGGGTGGTCCGCAGACACCGCTGTTACT|AGCCGTAGTGAGCCGTATTGTACTGCATGG
ATGCGCTGCTGACCCGCTCCTATTGAATAA|GGGGTGGTCCGCAGACACCGCTGTTACTGA
CCGATACTTTTCTCGAAAATAGTGGTCCGC|AGCAGGTCCGCAGACACCGCTGTTACTGAG
GTCCGCAGACACCGCTGTTACTGAGCACCA|GGCATAGTCAACAACTGTGAGCTTTAGCAC
GGATGATAATACGTGGTCCGCAGACACCGC|TCTGTGGTGGTCCGCAGACACCGCTGTTAC
TATGCGCTGCTGACCCGCTCCTATTGAATA|TGGGGTGGTCCGCAGACACCGCTGTTACTG
GTCCGCAGACACCGCTGTTACTGAGCAAAA|TTGAATAACTTCACGGATGCGGTGAATGCA
ATAGGATGATAATACGTGGTCCGCAGACAC|ATATCTGTGGTGGTCCGCAGACACCGCTGT
AGGGGTGGTCCGCAGACACCGCTGTTACTG|GCTCCTATTGAATAACTTCACGGATGCGGT
TCTCCTACATATGCCGTTAGCTTGCTGCAT|AGCCTTTGGGAACGGAATTCAGTCCTTTAG
GATGGTGGTCCGCAGACACCGCTGTTACTG|GTCCGCAGACACCGCTGTTACTGAGCAAAA
CATCATGGATTTGTATACGGTGCAGGCGCC|GGTCCGCAGACACCGCTGTTAGTGGTCCGC
CTGCGCGTGTTCGCATGGGGTGGTCCGCAG|TTGGTAGGATTTAAAGCCGTAGTGAGCCGT
ACAGAAGCGAGGCTGCGATTCCAGGTGTAA|TCTGGCCATGAGAATGCGCATAAGAATTTC
GACACCGCTGTTACTGAGCAACTCCTTGGT|GTTACTGAGCACTGAGCATAGGCAATCTTT
GCTTAAAGCTATAGGATGATAATACGTGGT|AACACTTACAATATCTGTGGTGGTCCGCAG
CAGACACCGCTGTTACTGAGCAACTCCTTG|CTGTTACTGAGCACTGAGCATAGGCAATCT
GTTGGCTAGGAGACGGTTTGGACCGCGGCG|TCCGTTCGATCTCCTACATATGCCGTTAGC
AGGCTGCGATTCCAGGTGTAAGGGCAGCCT|GAGAATGCGCATAAGAATTTCGACCCGGGT
GATAATACGTGGTCCGCAGACACCGCTGTT|TGGTGGTCCGCAGACACCGCTGTTACTGAG
GTCCGCAGACACCGCTGTTACTGAGCAACT|CACCGCTGTTACTGAGCACTGAGCATAGGC
GCAAATGCACAAACTGGAGTGGTCCGCAGA|GCCTGGGGTGCTGTACGCACATGGCTCCGG
CCTCGTACCAACACTTACAATATCTGTGGT|AAATAGTGGTCCGCAGACACCGCTGTTACT
GCAGACACCGCTGTTACTGAGCATAACACA|AGAGCCCATGAGGATGCCACAGAGTTCTGA
TGGTCCGCAGACACCGCTGTTACTGAGCAA|CAGACACCGCTGTTACTGAGCAAAAGGGTT
ACCGCTGTTACTGAGCAACTCCTTGGTGGT|ACTGAGCACTGAGCATAGGCAATCTTTCGC
TCCGCAGACACCGCTGTTACTGAGCAAGCT|GAGCCGTATTGTACTGCATGGAGAGTCCCG
ACCGTGACGGTCGGCGGATGGTGGTCCGCA|TGCACAAACTGGAGTGGTCCGCAGACACCG
CATGAGAATGCGCATAAGAATTTCGACCCG|CGTTGACGTCATTGCTATTCGCGCATAAGC
TATGGACTGTCTTAACGACGATTATGTATG|GTTACTGAGCACTGCGCGTGTTCGCATGGG
ACACCGCTGTTACTGAGCATTTTCATTGGT|TGGCTAGGAGACGGTTTGGACCGCGGCGTA
CACAGAGTTCTGACGGAGCGGGTGGTCCGC|TGTTACTGAGCAAAATACGAACAAGGCATA
ATAGCGAGAGGGTGTGGTCCGCAGACACCG|TGGAAACCGTGACGGTCGGCGGATGGTGGT
AAGCCGTAGTGAGCCGTATTGTACTGCATG|AGCGAGAGGGTGTGGTCCGCAGACACCGCT
GGGTCAGTAAGACGCCTATCGGCTCTGAGC|CCCCACCGTCATCTACTCAGAGACAAGAGT
GAGCACTGAGCATAGGCAATCTTTCGCGGA|GGTACCACCAGGCTTGAAACTAGGAGGGGT
TGAGCAGCTTGTCTATGGCAAGGCTGATTA|CAGACACCGCTGTTACTGAGCATAACACAA
TGTCTTTTTCGCAGCTAACATCATGGATTT|TACGCTTTTATCACAGGTGGTCCGCAGACA
GCTGTTACTGAGCAATATAGTTATTGACAG|CTGAGCAAAAGGGTTGAACGATCTACTCTG
AGGCTTGAAACTAGGAGGGGTGGTCCGCAG|ATGCGCTGCTGACCCGCTCCTATTGAATAA
TTCGACCCGGGTCAGTAAGACGCCTATCGG|CGCATAAGCCCCACCGTCATCTACTCAGAG
CTGCGATTCCAGGTGTAAGGGCAGCCTTTG|AATGCGCATAAGAATTTCGACCCGGGTCAG
GGGTGTGGTCCGCAGACACCGCTGTTACTG|TGACGGTCGGCGGATGGTGGTCCGCAGACA
CGCTGCTGACCCGCTCCTATTGAATAACTT|GTGGTCCGCAGACACCGCTGTTACTGAGCA
AGTCCTTTAGCAAATGCACAAACTGGAGTG|CGGCTCTGAGCCTGGGGTGCTGTACGCACA
CTCGTCGTGGTCCGCAGACACCGCTGTTAC|GCTGTTACTGAGCAACTCCTTGGTGGTCCG
ACTCATGATAGCGAGAGGGTGTGGTCCGCA|TGCTGCATGGAAACCGTGACGGTCGGCGGA
AACTGGAGTGGTCCGCAGACACCGCTGTTA|TGTACGCACATGGCTCCGGATAACTCGGGC
CACCGCTGTTACTGAGCAATACATTGTAAC|CAATATAGTTATTGACAGAAGCGAGGCTGC
CCGTGGTCCGCAGACACCGCTGTTACTGAG|GCAGACACCGCTGTTACTGAGCACTGAGCA
ATGGACTGTCTTAACGACGATTATGTATGC|TTACTGAGCACTGCGCGTGTTCGCATGGGG
AGCAATATAGTTATTGACAGAAGCGAGGCT|GGGTTGAACGATCTACTCTGGCCATGAGAA
CGGCGTACTCATGATAGCGAGAGGGTGTGG|TTAGCTTGCTGCATGGAAACCGTGACGGTC
CCGCTGTTACTGAGCATAACACAAGCCGAG|ATGAGGATGCCACAGAGTTCTGACGGAGCG
TGGTAGGATTTAAAGCCGTAGTGAGCCGTA|CGTACTCATGATAGCGAGAGGGTGTGGTCC
CTCCGTTCGATCTCCTACATATGCCGTTAG|GTGTAAGGGCAGCCTTTGGGAACGGAATTC
GTCCGCAGACACCGCTGTTACTGAGCATAA|GCGGAGAGCCCATGAGGATGCCACAGAGTT
GGGTGGTCCGCAGACACCGCTGTTACTGAG|CGTAGTGAGCCGTATTGTACTGCATGGAGA
TGGTCCGCAGACACCGCTGTTACTGAGCAC|TTACTGAGCAATACATTGTAACCAGTTGCC
TGAGCACGGTTGGCTAGGAGACGGTTTGGA|AGTTGCCCTCCGTTCGATCTCCTACATATG
AGCAATACATTGTAACCAGTTGCCCTCCGT|ACAGAAGCGAGGCTGCGATTCCAGGTGTAA
GGTGGTCCGCAGACACCGCTGTTACTGAGC|ACTGAGCACGGTTGGCTAGGAGACGGTTTG
CATTGGTAGGATTTAAAGCCGTAGTGAGCC|CGGCGTACTCATGATAGCGAGAGGGTGTGG
AGACACCGCTGTTAGTGGTCCGCAGACACC|TGAGCACCACTTCTAGAAAGATGTGCGGTA
GGAGTGGTCCGCAGACACCGCTGTTACTGA|CGCACATGGCTCCGGATAACTCGGGCGGAA
GCCGTAGTGAGCCGTATTGTACTGCATGGA|CGAGAGGGTGTGGTCCGCAGACACCGCTGT
TCCTTGGTGGTCCGCAGACACCGCTGTTAC|CAATCTTTCGCGGAGAGCCCATGAGGATGC
GAGACGGTTTGGACCGCGGCGTACTCATGA|TCTCCTACATATGCCGTTAGCTTGCTGCAT
AATAGTGGTCCGCAGACACCGCTGTTACTG|CGCTGTTACTGAGCAATACATTGTAACCAG
GCTGTTACTGAGCAAAAGGGTTGAACGATC|CTCGGGCGGAAGAGCGATCTATTCCACTTG
GCTGCTGACCCGCTCCTATTGAATAACTTC|TGGTCCGCAGACACCGCTGTTACTGAGCAA
TTCTGACGGAGCGGGTGGTCCGCAGACACC|GAGCAAAATACGAACAAGGCATAGTCAACA
AACGATCTACTCTGGCCATGAGAATGCGCA|CCACTTGGGGCAAAACCGTTGACGTCATTG
GACCACTCGTCGTGGTCCGCAGACACCGCT|ACACCGCTGTTACTGAGCAACTCCTTGGTG
GGATTTGTATACGGTGCAGGCGCCGTGGTC|CAGACACCGCTGTTAGTGGTCCGCAGACAC
TACGCTTTTATCACAGGTGGTCCGCAGACA|GGTGGTCCGCAGACACCGCTGTTACTGAGC
AATAACTTCACGGATGCGGTGAATGCACGT|ACTGAGCAAGCTGAGGTATCGGGTTCCTCG
CTGAGCACTGAGCATAGGCAATCTTTCGCG|CAGGTACCACCAGGCTTGAAACTAGGAGGG
TGGTGGTCCGCAGACACCGCTGTTACTGAG|CTTTCGCGGAGAGCCCATGAGGATGCCACA
ACACCGCTGTTACTGAGCAGGTCCGCAGAC|GGTGGTCCGCAGACACCGCTGTTACTGAGC
GCGCTGCTGACCCGCTCCTATTGAATAACT|GGTGGTCCGCAGACACCGCTGTTACTGAGC
GAAAGATGTGCGGTATATTCTCCAGGTACC|ACGTGTTATGGACTGTCTTAACGACGATTA
GGTCCGCAGACACCGCTGTTAGTGGTCCGC|CTGTTACTGAGCACCACTTCTAGAAAGATG
TCACGGATGCGGTGAATGCACGTTCGAGCT|AAGCTGAGGTATCGGGTTCCTCGTACCAAC
ATGAGGATGCCACAGAGTTCTGACGGAGCG|CAGACACCGCTGTTACTGAGCAAAATACGA
AATACATTGTAACCAGTTGCCCTCCGTTCG|GAAGCGAGGCTGCGATTCCAGGTGTAAGGG
CCTTGGTGGTCCGCAGACACCGCTGTTACT|AATCTTTCGCGGAGAGCCCATGAGGATGCC
ACGGTTTGGACCGCGGCGTACTCATGATAG|CCTACATATGCCGTTAGCTTGCTGCATGGA
ACCAGGCTTGAAACTAGGAGGGGTGGTCCG|TGTATGCGCTGCTGACCCGCTCCTATTGAA
AGCGAGGCTGCGATTCCAGGTGTAAGGGCA|CCATGAGAATGCGCATAAGAATTTCGACCC
GTCCGCAGACACCGCTGTTACTGAGCAATA|GACACCGCTGTTACTGAGCAAAAGGGTTGA
CTTCACGGATGCGGTGAATGCACGTTCGAG|GCAAGCTGAGGTATCGGGTTCCTCGTACCA
GATCTACTCTGGCCATGAGAATGCGCATAA|CTTGGGGCAAAACCGTTGACGTCATTGCTA
TCTGTGGTGGTCCGCAGACACCGCTGTTAC|CTGTTACTGAGCACGGTTGGCTAGGAGACG
GGGTGGTCCGCAGACACCGCTGTTACTGAG|AACAAGGCATAGTCAACAACTGTGAGCTTT
CACCGCTGTTACTGAGCAACTCCTTGGTGG|TACTGAGCACTGAGCATAGGCAATCTTTCG
CACCGCTGTTAGTGGTCCGCAGACACCGCT|GCACCACTTCTAGAAAGATGTGCGGTATAT
GAGCATAACACAAGCCGAGTACGCTTTTAT|ACAGAGTTCTGACGGAGCGGGTGGTCCGCA
GGGGTGGTCCGCAGACACCGCTGTTACTGA|CTCCTATTGAATAACTTCACGGATGCGGTG
AAACTAGGAGGGGTGGTCCGCAGACACCGC|GCTGACCCGCTCCTATTGAATAACTTCACG
CATGAGGATGCCACAGAGTTCTGACGGAGC|GCAGACACCGCTGTTACTGAGCAAAATACG
AGCAAAAGGGTTGAACGATCTACTCTGGCC|AGAGCGATCTATTCCACTTGGGGCAAAACC
CCGCAGACACCGCTGTTACTGAGCAGGTCC|GCGGATGGTGGTCCGCAGACACCGCTGTTA
TGAGCATAACACAAGCCGAGTACGCTTTTA|CACAGAGTTCTGACGGAGCGGGTGGTCCGC
TAGTTATTGACAGAAGCGAGGCTGCGATTC|ACGATCTACTCTGGCCATGAGAATGCGCAT
TGTTACTGAGCAATATAGTTATTGACAGAA|GAGCAAAAGGGTTGAACGATCTACTCTGGC
CCGCGGCGTACTCATGATAGCGAGAGGGTG|CCGTTAGCTTGCTGCATGGAAACCGTGACG
CCGCAGACACCGCTGTTACTGAGCAAAATA|GAATAACTTCACGGATGCGGTGAATGCACG
TAACATCATGGATTTGTATACGGTGCAGGC|GGTGGTCCGCAGACACCGCTGTTAGTGGTC
AGCCGTAGTGAGCCGTATTGTACTGCATGG|GCGAGAGGGTGTGGTCCGCAGACACCGCTG
GGCGGACCACTCGTCGTGGTCCGCAGACAC|GCAGACACCGCTGTTACTGAGCAACTCCTT
GGTCCGCAGACACCGCTGTTACTGAGCATA|CGCGGAGAGCCCATGAGGATGCCACAGAGT
AGTTCTGACGGAGCGGGTGGTCCGCAGACA|CTGAGCAAAATACGAACAAGGCATAGTCAA
ACCACTCGTCGTGGTCCGCAGACACCGCTG|CACCGCTGTTACTGAGCAACTCCTTGGTGG
GGTCCGCAGACACCGCTGTTACTGAGCAAG|GTGAGCCGTATTGTACTGCATGGAGAGTCC
CTGTTACTGAGCATAACACAAGCCGAGTAC|AGGATGCCACAGAGTTCTGACGGAGCGGGT
AGCAGCTTGTCTATGGCAAGGCTGATTAAA|GACACCGCTGTTACTGAGCATAACACAAGC
CTGGCCATGAGAATGCGCATAAGAATTTCG|AAAACCGTTGACGTCATTGCTATTCGCGCA
GGTCAGTAAGACGCCTATCGGCTCTGAGCC|CCCACCGTCATCTACTCAGAGACAAGAGTC
ACACCGCTGTTACTGAGCACTGAGCATAGG|CGGTATATTCTCCAGGTACCACCAGGCTTG
CTCTGGCCATGAGAATGCGCATAAGAATTT|GCAAAACCGTTGACGTCATTGCTATTCGCG
ACTTCACGGATGCGGTGAATGCACGTTCGA|AGCAAGCTGAGGTATCGGGTTCCTCGTACC
GAACGATCTACTCTGGCCATGAGAATGCGC|TCCACTTGGGGCAAAACCGTTGACGTCATT
GAGCATAGGCAATCTTTCGCGGAGAGCCCA|CCAGGCTTGAAACTAGGAGGGGTGGTCCGC
TGGGGTGGTCCGCAGACACCGCTGTTACTG|GCCGTAGTGAGCCGTATTGTACTGCATGGA
ACTGAGCAGGTCCGCAGACACCGCTGTTAC|GACACCGCTGTTACTGAGCAATATAGTTAT
AACACTTACAATATCTGTGGTGGTCCGCAG|TCCGCAGACACCGCTGTTACTGAGCACGGT
CCGCAGACACCGCTGTTACTGAGCAAAAGG|GCTCCGGATAACTCGGGCGGAAGAGCGATC
CTATAGGATGATAATACGTGGTCCGCAGAC|CAATATCTGTGGTGGTCCGCAGACACCGCT
CGCAGACACCGCTGTTACTGAGCAAGCTGA|GCCGTATTGTACTGCATGGAGAGTCCCGAT
CTTTTTCGCAGCTAACATCATGGATTTGTA|GCTTTTATCACAGGTGGTCCGCAGACACCG
CGCTGTTACTGAGCAGCTTGTCTATGGCAA|GGTGGTCCGCAGACACCGCTGTTACTGAGC
CCGCAGACACCGCTGTTACTGAGCAACTCC|CCGCTGTTACTGAGCACTGAGCATAGGCAA
GCAGACACCGCTGTTACTGAGCAGGTCCGC|GGATGGTGGTCCGCAGACACCGCTGTTACT
CATTGTAACCAGTTGCCCTCCGTTCGATCT|CGAGGCTGCGATTCCAGGTGTAAGGGCAGC
GTTACTGAGCAGCTTGTCTATGGCAAGGCT|GTCCGCAGACACCGCTGTTACTGAGCATAA
GCAGACACCGCTGTTACTGAGCAAGCTGAG|CCGTATTGTACTGCATGGAGAGTCCCGATA
GTTAGTGGTCCGCAGACACCGCTGTTACTG|TTCTAGAAAGATGTGCGGTATATTCTCCAG
TGAATGCACGTTCGAGCTTAAAGCTATAGG|CGGGTTCCTCGTACCAACACTTACAATATC
GCGGTGAATGCACGTTCGAGCTTAAAGCTA|GTATCGGGTTCCTCGTACCAACACTTACAA
ACCGCTGTTACTGAGCACTGAGCATAGGCA|GTATATTCTCCAGGTACCACCAGGCTTGAA
TACTCTGGCCATGAGAATGCGCATAAGAAT|GGGCAAAACCGTTGACGTCATTGCTATTCG
AGCAGGTCCGCAGACACCGCTGTTACTGAG|CCGCTGTTACTGAGCAATATAGTTATTGAC
TAGGATTTAAAGCCGTAGTGAGCCGTATTG|ACTCATGATAGCGAGAGGGTGTGGTCCGCA
ATCTACTCTGGCCATGAGAATGCGCATAAG|TTGGGGCAAAACCGTTGACGTCATTGCTAT
AGGCAATCTTTCGCGGAGAGCCCATGAGGA|TTGAAACTAGGAGGGGTGGTCCGCAGACAC
TATCGGGTTCCTCGTACCAACACTTACAAT|TTTTCTCGAAAATAGTGGTCCGCAGACACC
TATAGTTATTGACAGAAGCGAGGCTGCGAT|GAACGATCTACTCTGGCCATGAGAATGCGC
ACTCTGGCCATGAGAATGCGCATAAGAATT|GGCAAAACCGTTGACGTCATTGCTATTCGC
AGACACCGCTGTTACTGAGCAAAATACGAA|AACTTCACGGATGCGGTGAATGCACGTTCG
CAGTTGCCCTCCGTTCGATCTCCTACATAT|GATTCCAGGTGTAAGGGCAGCCTTTGGGAA
CACCGCTGTTACTGAGCAAAATACGAACAA|TTCACGGATGCGGTGAATGCACGTTCGAGC
GGTCGGCGGATGGTGGTCCGCAGACACCGC|CTGGAGTGGTCCGCAGACACCGCTGTTACT
GAGCCGTATTGTACTGCATGGAGAGTCCCG|TGTGGTCCGCAGACACCGCTGTTACTGAGC
ACTAGGAGGGGTGGTCCGCAGACACCGCTG|TGACCCGCTCCTATTGAATAACTTCACGGA
TCCGCAGACACCGCTGTTACTGAGCAGCTT|AGCAACTCCTTGGTGGTCCGCAGACACCGC
GAGAGGGTGTGGTCCGCAGACACCGCTGTT|ACCGTGACGGTCGGCGGATGGTGGTCCGCA
CAATCTTTCGCGGAGAGCCCATGAGGATGC|AAACTAGGAGGGGTGGTCCGCAGACACCGC
ACTGAGCAAAAGGGTTGAACGATCTACTCT|CGGAAGAGCGATCTATTCCACTTGGGGCAA
GCGGGTGGTCCGCAGACACCGCTGTTACTG|CGAACAAGGCATAGTCAACAACTGTGAGCT
ACCGCTGTTACTGAGCATAACACAAGCCGA|CATGAGGATGCCACAGAGTTCTGACGGAGC
AATTCAGTCCTTTAGCAAATGCACAAACTG|CCTATCGGCTCTGAGCCTGGGGTGCTGTAC
CAACTGTGAGCTTTAGCACCACAGAACGTG|GGATGATAATACGTGGTCCGCAGACACCGC
TAACCAGTTGCCCTCCGTTCGATCTCCTAC|CTGCGATTCCAGGTGTAAGGGCAGCCTTTG
GCAGACACCGCTGTTACTGAGCACCACTTC|TAGTCAACAACTGTGAGCTTTAGCACCACA
ACACTTACAATATCTGTGGTGGTCCGCAGA|CCGCAGACACCGCTGTTACTGAGCACGGTT
AGAATGCGCATAAGAATTTCGACCCGGGTC|GACGTCATTGCTATTCGCGCATAAGCCCCA
CGAAAATAGTGGTCCGCAGACACCGCTGTT|ACACCGCTGTTACTGAGCAATACATTGTAA
AGCACCACTTCTAGAAAGATGTGCGGTATA|TTAGCACCACAGAACGTGTTATGGACTGTC
TGGAGAGTCCCGATACTTTTCTCGAAAATA|CTGTTACTGAGCAGGTCCGCAGACACCGCT
ACGTGTTATGGACTGTCTTAACGACGATTA|ACCGCTGTTACTGAGCACTGCGCGTGTTCG
GCATAACACAAGCCGAGTACGCTTTTATCA|AGAGTTCTGACGGAGCGGGTGGTCCGCAGA
CAGACACCGCTGTTACTGAGCAATATAGTT|CGCTGTTACTGAGCAAAAGGGTTGAACGAT
GCTGTTACTGAGCAGCTTGTCTATGGCAAG|GTGGTCCGCAGACACCGCTGTTACTGAGCA
GACGGTTTGGACCGCGGCGTACTCATGATA|TCCTACATATGCCGTTAGCTTGCTGCATGG
GGGGTGGTCCGCAGACACCGCTGTTACTGA|CCGTAGTGAGCCGTATTGTACTGCATGGAG
AGCTTAAAGCTATAGGATGATAATACGTGG|CAACACTTACAATATCTGTGGTGGTCCGCA
GTCCGCAGACACCGCTGTTACTGAGCAATA|GTTACTGAGCAATATAGTTATTGACAGAAG
GTATATTCTCCAGGTACCACCAGGCTTGAA|CTGTCTTAACGACGATTATGTATGCGCTGC
GCGTACTCATGATAGCGAGAGGGTGTGGTC|AGCTTGCTGCATGGAAACCGTGACGGTCGG
ATAAGAATTTCGACCCGGGTCAGTAAGACG|GCTATTCGCGCATAAGCCCCACCGTCATCT
GTTACTGAGCAATACATTGTAACCAGTTGC|GTTATTGACAGAAGCGAGGCTGCGATTCCA
GTTAGCTTGCTGCATGGAAACCGTGACGGT|AATTCAGTCCTTTAGCAAATGCACAAACTG
ATAACTTCACGGATGCGGTGAATGCACGTT|CTGAGCAAGCTGAGGTATCGGGTTCCTCGT
TGCACAAACTGGAGTGGTCCGCAGACACCG|GGGTGCTGTACGCACATGGCTCCGGATAAC
GAGCTTAAAGCTATAGGATGATAATACGTG|CCAACACTTACAATATCTGTGGTGGTCCGC
GTCCGCAGACACCGCTGTTACTGAGCAAAA|TGGCTCCGGATAACTCGGGCGGAAGAGCGA
TCCGCAGACACCGCTGTTACTGAGCATTTT|GCACGGTTGGCTAGGAGACGGTTTGGACCG
TATTGACAGAAGCGAGGCTGCGATTCCAGG|TCTACTCTGGCCATGAGAATGCGCATAAGA
TCCGCAGACACCGCTGTTACTGAGCACTGA|AGATGTGCGGTATATTCTCCAGGTACCACC
TAGGAGGGGTGGTCCGCAGACACCGCTGTT|ACCCGCTCCTATTGAATAACTTCACGGATG
GGTCCGCAGACACCGCTGTTACTGAGCAGC|TGAGCAACTCCTTGGTGGTCCGCAGACACC
TGAGCAAAATACGAACAAGGCATAGTCAAC|GTGAATGCACGTTCGAGCTTAAAGCTATAG
CGGAGAGCCCATGAGGATGCCACAGAGTTC|GGGTGGTCCGCAGACACCGCTGTTACTGAG
GCAGCCTTTGGGAACGGAATTCAGTCCTTT|CCCGGGTCAGTAAGACGCCTATCGGCTCTG
CGCAGACACCGCTGTTACTGAGCAAAATAC|AATAACTTCACGGATGCGGTGAATGCACGT
CCGCAGACACCGCTGTTACTGAGCAATACA|TACTGAGCAATATAGTTATTGACAGAAGCG
GACAGAAGCGAGGCTGCGATTCCAGGTGTA|CTCTGGCCATGAGAATGCGCATAAGAATTT
CTGTTACTGAGCAATACATTGTAACCAGTT|TAGTTATTGACAGAAGCGAGGCTGCGATTC
GGACCACTCGTCGTGGTCCGCAGACACCGC|GACACCGCTGTTACTGAGCAACTCCTTGGT
TCGGGTTCCTCGTACCAACACTTACAATAT|TTCTCGAAAATAGTGGTCCGCAGACACCGC
CGTGACGGTCGGCGGATGGTGGTCCGCAGA|CACAAACTGGAGTGGTCCGCAGACACCGCT
TGCGCATAAGAATTTCGACCCGGGTCAGTA|TCATTGCTATTCGCGCATAAGCCCCACCGT
CGTGGTCCGCAGACACCGCTGTTACTGAGC|CCGCAGACACCGCTGTTACTGAGCATTTTC
GCAAAAGGGTTGAACGATCTACTCTGGCCA|GAGCGATCTATTCCACTTGGGGCAAAACCG
TGAGCATAGGCAATCTTTCGCGGAGAGCCC|ACCAGGCTTGAAACTAGGAGGGGTGGTCCG
TCTACTCTGGCCATGAGAATGCGCATAAGA|TGGGGCAAAACCGTTGACGTCATTGCTATT
TCCTACATATGCCGTTAGCTTGCTGCATGG|CCTTTGGGAACGGAATTCAGTCCTTTAGCA
ACACCGCTGTTACTGAGCAACTCCTTGGTG|TTACTGAGCACTGAGCATAGGCAATCTTTC
GTATGCGCTGCTGACCCGCTCCTATTGAAT|ATGGGGTGGTCCGCAGACACCGCTGTTACT
CCATGAGAATGCGCATAAGAATTTCGACCC|CCGTTGACGTCATTGCTATTCGCGCATAAG
GTCCGCAGACACCGCTGTTACTGAGCAAGC|TGAGCCGTATTGTACTGCATGGAGAGTCCC
AGCAAAATACGAACAAGGCATAGTCAACAA|GAATGCACGTTCGAGCTTAAAGCTATAGGA
TCCGCAGACACCGCTGTTACTGAGCACGGT|CTGAGCAATACATTGTAACCAGTTGCCCTC
TTACAATATCTGTGGTGGTCCGCAGACACC|AGACACCGCTGTTACTGAGCACGGTTGGCT
TGGTGGTCCGCAGACACCGCTGTTACTGAG|CCGCAGACACCGCTGTTACTGAGCAAAAGG
TGGTCCGCAGACACCGCTGTTAGTGGTCCG|GCTGTTACTGAGCACCACTTCTAGAAAGAT
CGCTGTTACTGAGCACCACTTCTAGAAAGA|AACTGTGAGCTTTAGCACCACAGAACGTGT
CAGACACCGCTGTTACTGAGCACTGAGCAT|GTGCGGTATATTCTCCAGGTACCACCAGGC
